# Spanish multiwords file used for chunking
A anequín	L_RG
A barlovento	L_RG
A barrisco	L_RG
A base de	L_SPS00
A base de bien	L_RG
A boca de cañón	L_RG
A bocajarro	L_RG
A bombo y platillo	L_RG
A borbollones	L_RG
A borbotones	L_RG
A bordo	L_RG
A bote pronto	L_RG
A brazo partido	L_RG
A bruces	L_RG
A buen recaudo	L_RG
A buen seguro	L_RG
A buen tino	L_RG
A buena cuenta	L_RG
A buena fe	L_RG
A buena luz	L_RG
A buena vista	L_RG
A buenas horas	L_RG
A buenas noches	L_RG
A bulto	L_RG
A cada instante	L_RG
A cada momento	L_RG
A cada paso	L_RG
A cada rato	L_RG
A cada trique	L_RG
A cada triquitraque	L_RG
A caja y espiga	L_RG
A cal y canto	L_RG
A caliche	L_RG
A cambio	L_RG
A cambio de	L_SPS00
A campo raso	L_RG
A campo traviesa	L_RG
A cara de perro	L_RG
A cara descubierta	L_RG
A carcajada limpia	L_RG
A cargo de	L_SPS00
A carretadas	L_RG
A carta cabal	L_RG
A casquete quitado	L_RG
A causa de	L_SPS00
A causa de que	L_CS
A centenares	L_RG
A cepillo	L_RG
A cerca de	L_SPS00
A cercen	L_RG
A cercén	L_RG
A chorros	L_RG
A cielo descubierto	L_RG
A ciencia cierta	L_RG
A codazo limpio	L_RG
A comisión	L_RG
A como de lugar	L_RG
A condición de	L_SPS00
A condición de que	L_CS
A consecuencia de	L_SPS00
A continuación de	L_SPS00
A contra reloj	L_RG
A contrahílo	L_RG
A contralecho	L_RG
A contramano	L_RG
A contrapelo	L_RG
A contrapié	L_RG
A corazón abierto	L_RG
A cordel	L_RG
A coro	L_RG
A costillas	L_RG
A coxcojilla	L_RG
A cruz y escuadra	L_RG
A cuatro patas	L_RG
A cuatro pies	L_RG
A cubos	L_RG
A cuenta de	L_SPS00
A cuerpo de rey	L_RG
A cuerpo descubierto	L_RG
A cuál más	L_RG
A cántaros	L_RG
A dentelladas	L_RG
A dentro	L_RG
A desmano	L_RG
A despecho	L_RG
A despecho de	L_SPS00
A destajo	L_RG
A destiempo	L_RG
A diario	L_RG
A dicho efecto	L_RG
A diferencia de	L_SPS00
A disgusto	L_RG
A distinción de	L_SPS00
A donde	L_RG
A dos dedos de	L_SPS00
A dos haces	L_RG
A dos manos	L_RG
A duras penas	L_RG
A dúo	L_RG
A efecto de que	L_CS
A efectos de	L_SPS00
A empellones	L_RG
A escape	L_RG
A escondidas	L_RG
A escondidillas	L_RG
A escote	L_RG
A escuadra	L_RG
A escusa	L_RG
A escusas	L_RG
A eso de	L_SPS00
A espaldas de	L_SPS00
A espeta perro	L_RG
A espinapez	L_RG
A espuertas	L_RG
A este lado de	L_SPS00
A excepción de	L_SPS00
A expensas	L_RG
A expensas de	L_SPS00
A fanegadas	L_RG
A favor de	L_SPS00
A fin de	L_SPS00
A fin de cuentas	L_RG
A fin de que	L_CS
A fines de	L_SPS00
A flor de agua	L_RG
A flor de piel	L_RG
A flote	L_RG
A fortiori	L_RG
A fuego lento	L_RG
A fuerza de	L_SPS00
A fuerza de que	L_CS
A gachas	L_RG
A gatas	L_RG
A gogó	L_RG
A grandes rasgos	L_RG
A granel	L_RG
A graves penas	L_RG
A guisa de	L_SPS00
A hito	L_RG
A horcajadas	L_RG
A hurtadillas	L_RG
A jarros	L_RG
A jornal	L_RG
A junta continua	L_RG
A juzgar como	L_RG
A juzgar por	L_SPS00
A la bartola	L_RG
A la buena ventura	L_RG
A la busca de	L_SPS00
A la chita callando	L_RG
A la cola	L_RG
A la espera de	L_SPS00
A la funerala	L_RG
A la inversa	L_RG
A la manera de	L_SPS00
A la mano de Dios	L_RG
A la mitad de	L_SPS00
A la morisma	L_RG
A la mujeriega	L_RG
A la papillote	L_RG
A la parrilla	L_RG
A la pata coja	L_RG
A la pata llana	L_RG
A la paz de Dios	L_RG
A la pendura	L_RG
A la perfección	L_RG
A la primera de cambio	L_RG
A la ronza	L_RG
A la siga de	L_SPS00
A la sirga	L_RG
A la sopa boba	L_RG
A la tentaruja	L_RG
A la tirolesa	L_RG
A la usanza de	L_SPS00
A la vez	L_RG
A la vez que	L_CS
A la vuelta de	L_SPS00
A la zona de	L_SPS00
A largas marchas	L_RG
A las calladas	L_RG
A las mil maravillas	L_RG
A las primeras de cambio	L_RG
A las puertas de la muerte	L_RG
A las veces	L_RG
A lata por canal	L_RG
A legua	L_RG
A leguas	L_RG
A libre plática	L_RG
A lo ancho de	L_SPS00
A lo bestia	L_RG
A lo discreto	L_RG
A lo garçon	L_RG
A lo grande	L_RG
A lo largo y a lo ancho	L_RG
A lo largo y ancho de	L_SPS00
A lo lejos	L_RG
A lo loco	L_RG
A lo moderno	L_RG
A lo más	L_RG
A lo que parece	L_RG
A lo que salga	L_RG
A lo sumo	L_RG
A lo tonto	L_RG
A lomo	L_RG
A lomos	L_RG
A los cuatro vientos	L_RG
A los piques	L_RG
A lumbre de pajas	L_RG
A lumbre mansa	L_RG
A lápiz	L_RG
A línea tirada	L_RG
A machamartillo	L_RG
A machote	L_RG
A mal dar	L_RG
A malas penas	L_RG
A manadas	L_RG
A manera de	L_SPS00
A mano airada	L_RG
A mano armada	L_RG
A manos llenas	L_RG
A mansalva	L_RG
A mares	L_RG
A mata caballo	L_RG
A matacaballo	L_RG
A mayor abundamiento	L_RG
A mazo y escoplo	L_RG
A media ladera	L_RG
A media madera	L_RG
A media margen	L_RG
A media rienda	L_RG
A media rodilla	L_RG
A media voz	L_RG
A mediados de	L_SPS00
A medias palabras	L_RG
A medida que	L_CS
A medio hacer	L_RG
A medio plazo	L_RG
A mediodía	L_RG
A medios pelos	L_RG
A menos que	L_CS
A mesa puesta	L_RG
A millaradas	L_RG
A mis anchas	L_RG
A mitad de	L_SPS00
A modo de	L_SPS00
A montón	L_RG
A mucha honra	L_RG
A muerte	L_AQ0CN0
A muerte	L_RG
A muerte o vida	L_RG
A mujeriega	L_RG
A más andar	L_RG
A más correr	L_RG
A más ganar	L_RG
A más mejor	L_RG
A más no poder	L_RG
A más tardar	L_RG
A más ver	L_RG
A más y mejor	L_RG
A nado	L_RG
A no ser que	L_CS
A nombre de	L_SPS00
A ojo de buen cubero	L_RG
A ojos vistas	L_RG
A pan y cuchillo	L_RG
A partir de	L_SPS00
A pasatoro	L_RG
A paseo	L_RG
A paso de tortuga	L_RG
A paso largo	L_RG
A pasto	L_RG
A pesar de	L_SPS00
A pesar de que	L_CS
A pesar de todo	L_RG
A peso de oro	L_RG
A petición de	L_SPS00
A peón	L_RG
A pica suelta	L_RG
A pico	L_RG
A pico de jarro	L_RG
A pie firme	L_RG
A pie llano	L_RG
A pierna suelta	L_RG
A pipiricojo	L_RG
A pique de maceta	L_RG
A plazo fijo	L_RG
A plazos	L_RG
A plomo	L_RG
A poco que	L_CS
A poco rato	L_RG
A pocos pasos	L_RG
A porfía	L_RG
A porrillo	L_RG
A pospelo	L_RG
A posteriori	L_RG
A pote	L_RG
A precio de coste	L_RG
A primera sangre	L_AQ0CN0
A principios de	L_SPS00
A priori	L_RG
A prisa	L_RG
A propósito de	L_SPS00
A prorrata	L_RG
A prueba de	L_SPS00
A puchos	L_RG
A puerta cerrada	L_RG
A puestas	L_RG
A punta de lanza	L_RG
A punta de pistola	L_RG
A punta pala	L_RG
A puntapiés	L_RG
A punto de	L_SPS00
A punto de caramelo	L_RG
A punto de que	L_CS
A punto de solfa	L_RG
A punto fijo	L_RG
A punto largo	L_RG
A pupilo	L_RG
A puñados	L_RG
A puño cerrado	L_RG
A quema ropa	L_RG
A quemarropa	L_RG
A rachas	L_RG
A raja tabla	L_RG
A rajatabla	L_RG
A ras de	L_SPS00
A ras de tierra	L_RG
A ras del suelo	L_RG
A rastras	L_RG
A ratos perdidos	L_RG
A raudales	L_RG
A razón de	L_SPS00
A raíz de	L_SPS00
A reculones	L_RG
A regaña dientes	L_RG
A regañadientes	L_RG
A rehala	L_RG
A rembolso	L_RG
A remiendos	L_RG
A remo	L_RG
A remojo	L_RG
A renglón seguido	L_RG
A reo	L_RG
A repecho	L_RG
A repelo	L_RG
A repelones	L_RG
A reserva de	L_SPS00
A resto abierto	L_RG
A retaguardia de	L_SPS00
A revienta cinchas	L_RG
A rienda suelta	L_RG
A riesgo de	L_SPS00
A riesgo y ventura	L_RG
A rodeabrazo	L_RG
A rompejunta	L_RG
A rostro firme	L_RG
A ruche	L_RG
A río revuelto	L_RG
A sabiendas	L_RG
A salto de mata	L_RG
A saltos	L_RG
A sangre caliente	L_RG
A sangre fría	L_RG
A sangre y fuego	L_RG
A santo de qué	L_RG
A sardinel	L_RG
A seguir bien	L_RG
A semejanza de	L_SPS00
A so capa	L_RG
A sobre haz	L_RG
A sobre peine	L_RG
A sobremano	L_RG
A socapa	L_RG
A soga	L_RG
A solapo	L_RG
A solas	L_RG
A solaz	L_RG
A sotamano	L_RG
A sotavento	L_RG
A su imagen y semejanza	L_RG
A suplicación de	L_SPS00
A sus anchas	L_RG
A súplica de	L_SPS00
A tal punto que	L_CS
A teja vana	L_RG
A tenor de	L_SPS00
A tientas	L_RG
A tiento	L_RG
A tirada	L_RG
A tiro de ballesta	L_RG
A tiro de pistola	L_RG
A tiro limpio	L_RG
A tizón	L_RG
A toca ropa	L_RG
A toca teja	L_RG
A tocateja	L_RG
A toda brida	L_RG
A toda costa	L_RG
A toda furia	L_RG
A toda hostia	L_RG
A toda leche	L_RG
A toda ley	L_RG
A toda marcha	L_RG
A toda mecha	L_RG
A toda máquina	L_RG
A toda pastilla	L_RG
A toda plana	L_RG
A toda prisa	L_RG
A toda rienda	L_RG
A todas estas	L_RG
A todas horas	L_RG
A todo andar	L_RG
A todo correr	L_RG
A todo evento	L_RG
A todo gas	L_RG
A todo lo largo	L_RG
A todo lo largo de	L_SPS00
A todo meter	L_RG
A todo moler	L_RG
A todo pasto	L_RG
A todo riesgo	L_RG
A todo ruedo	L_RG
A todo tirar	L_RG
A todo trance	L_RG
A todo vapor	L_RG
A tontas y a locas	L_RG
A topa tolondro	L_RG
A tope	L_RG
A toque de campana	L_RG
A torna peón	L_RG
A torna punta	L_RG
A torno	L_RG
A traición	L_RG
A trancas y barrancas	L_RG
A trancos	L_RG
A traque barraque	L_RG
A través de	L_SPS00
A trompa y talega	L_RG
A trompicones	L_RG
A tropezones	L_RG
A trueco de	L_SPS00
A trueque	L_RG
A tuertas	L_RG
A tuertas o a derechas	L_RG
A tuerto o a derecho	L_RG
A tutiplén	L_RG
A título de	L_SPS00
A ultranza	L_RG
A un lado de	L_SPS00
A un lado y otro	L_RG
A un solo efecto	L_RG
A uno y otro lado	L_RG
A upa	L_RG
A usanza de	L_SPS00
A vez que	L_CS
A vida o muerte	L_RG
A vista de pájaro	L_RG
A viva voz	L_RG
A voz en cuello	L_RG
A voz en grito	L_RG
A vuela pluma	L_RG
A vuelapluma	L_RG
A vuelco de dado	L_RG
A vuelta de	L_SPS00
A vuelta de correo	L_RG
A vuelta de ojo	L_RG
A vuelta de ojos	L_RG
Ab initio	L_RG
Ab intestato	L_RG
Ab ovo	L_RG
Abastecimiento de agua	L_NCMS000
Abastecimiento de agua potable	L_NCMS000
Abogado defensor	L_NC
Academia de bellas artes	L_NC
Accidente de trabajo	L_NC
Accidente laboral	L_NC
Acción educativa	L_NC
Acción militar	L_NC
Acción pública	L_NC
Aceite de oliva virgen	L_NCMS000
Acerca de	L_SPS00
Acre pie	L_NC
Acta de nacimiento	L_NC
Acta final	L_NC
Actividad artística	L_NC
Actividad económica	L_NC
Actividad empresarial	L_NC
Actividad extraescolar	L_NC
Actividad financiera	L_NC
Actividad humana	L_NC
Actividad industrial	L_NC
Actividad pesquera	L_NC
Actividades al aire libre	L_NCFP000
Acto administrativo	L_NC
Acto impugnado	L_NC
Acto jurídico	L_NC
Actuación administrativa	L_NC
Actuación judicial	L_NC
Acuerdo de paz	L_NC
Acuerdo internacional	L_NC
Ad hoc	L_RG
Ad interim	L_RG
Ad lib	L_RG
Ad libitum	L_RG
Ad litem	L_RG
Ad litteram	L_RG
Ad quadrantum	L_RG
Ad triangulum	L_RG
Ad valorem	L_RG
Además de	L_SPS00
Además de eso	L_RG
Además de que	L_CS
Administración civil	L_NC
Administración del estado	L_NC
Administración educativa	L_NC
Administración general	L_NC
Administración municipal	L_NC
Aeropuerto internacional	L_NC
Agencia de protección de datos	L_NC
Agencia de viajes	L_NC
Agencia espacial europea	L_NCFS000
Agenda electrónica	L_NC
Agente social	L_NC
Agresión sexual	L_NC
Agua destilada	L_NCFS000
Agua dulce	L_NCFS000
Agua subterránea	L_NC
Agua superficial	L_NC
Aguas continentales	L_NCFP000
Aguas pluviales	L_NCFP000
Aguas territoriales	L_NCFP000
Ahora bien	L_RG
Ahí es nada	L_RG
Ahí le duele	L_RG
Aire puro	L_NCMS000
Aislamiento térmico	L_NC
Al abrigo de	L_SPS00
Al alcance de la mano	L_RG
Al alimón	L_RG
Al apa	L_RG
Al avemaría	L_RG
Al bies	L_RG
Al cabo de	L_SPS00
Al calor de	L_SPS00
Al carboncillo	L_RG
Al cargo de	L_SPS00
Al centro de	L_SPS00
Al chas chas	L_RG
Al cien por cien	L_RG
Al cierre del ejercicio	L_RG
Al clarear el día	L_RG
Al compás de	L_SPS00
Al conjuro de	L_SPS00
Al correr de la pluma	L_RG
Al correr del tiempo	L_RG
Al decir de	L_SPS00
Al derredor de	L_SPS00
Al desbarate	L_RG
Al descuido y con cuidado	L_RG
Al desgaire	L_RG
Al detall	L_RG
Al estricote	L_RG
Al filo de	L_SPS00
Al filo de mediodía	L_RG
Al fin de la jornada	L_RG
Al fin y a la postre	L_RG
Al fin y al cabo	L_RG
Al frente de	L_SPS00
Al gratén	L_RG
Al grill	L_RG
Al gusto de	L_SPS00
Al hilo	L_RG
Al hilo de mediodía	L_RG
Al hilo del viento	L_RG
Al igual que	L_CS
Al interior de	L_SPS00
Al libre albedrío	L_RG
Al lucero del alba	L_RG
Al mejor tiempo	L_RG
Al modo de	L_SPS00
Al objeto de	L_SPS00
Al olor de	L_SPS00
Al otro lado de	L_SPS00
Al par que	L_CS
Al paso que	L_CS
Al paño	L_RG
Al pie de fábrica	L_RG
Al pie de la cuesta	L_RG
Al pie de la letra	L_RG
Al pie de la obra	L_RG
Al poco rato	L_RG
Al por mayor	L_RG
Al por menor	L_RG
Al primer envite	L_RG
Al primer folio	L_RG
Al primer gallo	L_RG
Al primer golpe de vista	L_RG
Al primer impulso	L_RG
Al punto que	L_CS
Al rape	L_RG
Al raso	L_RG
Al rededor	L_RG
Al retortero	L_RG
Al rojo blanco	L_RG
Al rojo cereza	L_RG
Al sesgo	L_RG
Al socaire	L_RG
Al socaire de	L_SPS00
Al tanto de	L_SPS00
Al temple	L_RG
Al tendido	L_RG
Al tenor de	L_SPS00
Al tiempo que	L_CS
Al tresbolillo	L_RG
Al volateo	L_RG
Alcaldía mayor	L_NCFS000
Alcohol etílico	L_NCMS000
Alguna que otra vez	L_RG
Algunas veces	L_RG
Alguno que otro	L_RG
Alianza estratégica	L_NC
Allende de	L_SPS00
Allá se andan	L_RG
Allá se las avenga	L_RG
Allá se las componga	L_RG
Allá se las haya	L_RG
Allá se las hayan	L_RG
Allá se van	L_RG
Alma humana	L_NC
Altar mayor	L_NCMS000
Alto comisionado de las naciones unidas para los refugiados	L_NCMN000
Alto el fuego	L_NCMS000
Ambiente de trabajo	L_NC
Ambiente familiar	L_NC
Ambiente social	L_NC
Anatomía humana	L_NCMS000
Anatomía patológica	L_NCMS000
Ancho de banda	L_NCMS000
Animal salvaje	L_NC
Antecedente personal	L_NC
Anterior a	L_SPS00
Antes bien	L_RG
Antes pues	L_RG
Antes que nada	L_RG
Antiguo régimen	L_NCMS000
Antropología cultural	L_NCMS000
Antropología filosófica	L_NCMS000
Anuario estadístico	L_NCMS000
Análisis clínico	L_NC
Análisis comparativo	L_NC
Análisis cualitativo	L_NC
Análisis cuantitativo	L_NC
Análisis de datos	L_NCMN000
Análisis de sangre	L_NCMN000
Análisis del discurso	L_NCMN000
Análisis económico	L_NC
Análisis estadístico	L_NC
Análisis funcional	L_NC
Análisis histórico	L_NC
Análisis químico	L_NC
Apartado de correos	L_NC
Aparte de	L_SPS00
Aplicación informática	L_NC
Apoyo docente	L_NC
Apoyo escolar	L_NC
Apoyo financiero	L_NC
Apoyo logístico	L_NC
Apoyo psicológico	L_NC
Apoyo social	L_NC
Apoyo técnico	L_NC
Aprendizaje significativo	L_NCMS000
Archivo general	L_NC
Arma biológica	L_NC
Arma nuclear	L_NC
Arma química	L_NC
Arquitecto técnico	L_NC
Arquitectura popular	L_NCFS000
Arreglo floral	L_NC
Arroz blanco	L_NCMS000
Art nouveau	L_NCMS000
Arte contemporáneo	L_NCCS000
Arte dramático	L_NCCS000
Arte medieval	L_NCCS000
Arte moderno	L_NCCS000
Arte popular	L_NC
Artes aplicadas	L_NCCP000
Artes audiovisuales	L_NCCP000
Asamblea general	L_NCFS000
Asamblea general extraordinaria	L_NCFS000
Asamblea general ordinaria	L_NCFS000
Asamblea nacional constituyente	L_NCFS000
Asamblea plenaria	L_NCFS000
Asamblea popular	L_NCFS000
Asesor fiscal	L_NC
Asesor jurídico	L_NC
Asesor legal	L_NC
Asesor técnico	L_NC
Asesoría jurídica	L_NC
Asesoría legal	L_NC
Asilo político	L_NCMS000
Asistencia legal	L_NC
Asistencia sanitaria	L_NCFS000
Asistencia técnica	L_NCFS000
Asma bronquial	L_NCFS000
Asociación civil	L_NC
Asociación de empresarios	L_NC
Asociación de vecinos	L_NC
Asociación empresarial	L_NC
Asociación profesional	L_NC
Así como también	L_RG
Así como tampoco	L_RG
Así pues	L_RG
Así y todo	L_RG
Atención al cliente	L_NCFS000
Atención directa	L_NCFS000
Atención domiciliaria	L_NCFS000
Atención médica	L_NCFS000
Atención personal	L_NCFS000
Atención sanitaria	L_NCFS000
Atención temprana	L_NCFS000
Audición y lenguaje	L_NCFS000
Audiencia nacional	L_NCFS000
Audiencia provincial	L_NC
Auditoría de cuentas	L_NC
Auditoría externo	L_NC
Auditoría interno	L_NC
Aula de informática	L_NC
Aumento de precio	L_NC
Automóvil club	L_NCMS000
Autonomía personal	L_NCFS000
Autoridad laboral	L_NC
Autorización expresa	L_NC
Autorización judicial	L_NC
Autorización previa	L_NC
Ayer noche	L_RG
Ayuda a domicilio	L_NCFS000
Ayuda humanitaria	L_NCFS000
Ayuda oficial	L_NC
Año de servicio	L_NC
Año fiscal	L_NC
Año natural	L_NC
Año sabático	L_NC
Aún así	L_RG
Aún con eso	L_RG
Aún cuando	L_RG
Bajo cuerda	L_RG
Bajo el poder de	L_SPS00
Bajo juramento	L_RG
Bajo la responsabilidad de	L_SPS00
Bajo llave	L_RG
Bajo mano	L_RG
Bajo ningún concepto	L_RG
Bajo siete llaves	L_RG
Banco bilbao vizcaya argentaria	L_NCMS000
Banco central europeo	L_NCMS000
Banco de pruebas	L_NC
Banco de sangre	L_NC
Banco mundial	L_NCMS000
Banco nacional	L_NCMS000
Banco santander central hispano	L_NCMS000
Banda ancha	L_NCFS000
Bandera nacional	L_NC
Bandera roja	L_NCFS000
Base de cálculo	L_NC
Base jurídica	L_NC
Biblioteca pública	L_NC
Bien de capital	L_NC
Bien entendido que	L_CS
Bien mirado	L_RG
Bien patrimonial	L_NC
Bien público	L_NC
Bien que mal	L_RG
Bien sabe Dios que	L_CS
Bienestar social	L_NCMS000
Biología molecular	L_NCMS000
Bioquímica clínica	L_NCMS000
Bloqueo económico	L_NCMS000
Boca arriba	L_RG
Boletín oficial de navarra	L_NCMS000
Boletín oficial del estado	L_NCMS000
Bolsa de comercio	L_NCFS000
Bolsa de plástico	L_NC
Bosque tropical	L_NC
Buzón de correo	L_NC
Buzón de correo electrónico	L_NC
Bóbilis bóbilis	L_RG
Cada cosa por su lado	L_RG
Cada dos por tres	L_RG
Cadena de producción	L_NC
Cadena de tiendas	L_NC
Caja de herramientas	L_NC
Calidad asistencial	L_NCFS000
Calidad de vida	L_NCFS000
Calidad del agua	L_NCFS000
Cambio climático	L_NCMS000
Cambio de gobierno	L_NC
Cambio de uso	L_NCMS000
Campaña de promoción	L_NC
Campaña electoral	L_NC
Campaña política	L_NC
Campeonato mundial	L_NC
Campeonato nacional	L_NC
Campeón mundial	L_NC
Campo de aplicación	L_NC
Campo de fútbol	L_NC
Campo de golf	L_NC
Campo de juego	L_NC
Campo eléctrico	L_NC
Campo magnético	L_NC
Campus universitario	L_NC
Canción de amor	L_NC
Cantidad de energía	L_NCFS000
Cantidad de información	L_NCFS000
Capacidad creativa	L_NC
Capacidad de aprendizaje	L_NCFS000
Capacidad de obrar	L_NCFS000
Capacidad jurídica	L_NC
Capacidad legal	L_NC
Capacidad operativa	L_NC
Capital de riesgo	L_NCFS000
Capital humano	L_NCFS000
Capital riesgo	L_NCFS000
Captura de datos	L_NC
Cara a cara	L_RG
Cara abajo	L_RG
Cara arriba	L_RG
Carga de trabajo	L_NC
Carga eléctrica	L_NC
Carnet de conducir	L_NC
Carpe diem	L_RG
Carta apostólica	L_NC
Carta certificada	L_NC
Carta de las naciones unidas	L_NCFS000
Carta magna	L_NC
Cartera de clientes	L_NC
Cartera de valores	L_NC
Casa rural	L_NC
Casi geostrófico	L_RG
Casi que	L_CS
Celebración eucarística	L_NC
Censo de población	L_NC
Central hidroeléctrica	L_NC
Central nuclear	L_NC
Central térmica	L_NC
Centro asistencial	L_NC
Centro cívico	L_NC
Centro de atención al cliente	L_NC
Centro de documentación	L_NC
Centro de día	L_NC
Centro de gestión	L_NC
Centro de rehabilitación	L_NC
Centro escolar	L_NC
Centro hospitalario	L_NC
Centro penitenciario	L_NC
Centímetro Fh s	L_NC
Centímetro Fh segundo	L_NC
Centímetro cuadrado	L_NC
Centímetro cúbico	L_NC
Centímetro cúbico Fh segundo	L_NC
Centímetro cúbico por segundo	L_NC
Centímetro de hg	L_NC
Centímetro de mercurio	L_NC
Centímetro por segundo	L_NC
Centímetro segundo	L_NC
Cepillo de dientes	L_NC
Ceremonia de clausura	L_NC
Certificado de asistencia	L_NC
Certificado de estudios	L_NC
Certificado de nacimiento	L_NC
Cheque certificado	L_NC
Chino mandarín	L_NC
Chorro de agua	L_NC
Ciclo económico	L_NC
Ciclo formativo	L_NC
Ciclo vital	L_NC
Cien por cien	L_RG
Ciencia biológica	L_NC
Ciencia de la educación	L_NC
Ciencia de la naturaleza	L_NC
Ciencia empresarial	L_NC
Ciento por ciento	L_RG
Ciento y la madre	L_RG
Cifra de negocio	L_NC
Cine de terror	L_NCMS000
Cine documental	L_NCMS000
Cine erótico	L_NCMS000
Cine fantástico	L_NCMS000
Cinta adhesiva	L_NCFS000
Circuito cerrado	L_NC
Circulación sanguínea	L_NCFS000
Cirugía torácica	L_NCFS000
Cirugía vascular	L_NCFS000
Clase obrera	L_NCFS000
Clase política	L_NCFS000
Clase social	L_NC
Clase trabajadora	L_NC
Claustro de profesores	L_NC
Clave de acceso	L_NC
Clima mediterráneo	L_NCMS000
Clima templado	L_NCMS000
Clima tropical	L_NCMS000
Cm Fh s	L_NCFS000
Cm3 Fh s	L_NCFS000
Cm3 Fh seg	L_NCFS000
Cochite hervite	L_RG
Codo a codo	L_RG
Codo con codo	L_RG
Colección privada	L_NC
Colegio de abogados	L_NC
Colegio nacional	L_NC
Colegio público	L_NC
Comandante en jefe	L_NCCS000
Comercio bilateral	L_NCMS000
Comercio justo	L_NCMS000
Comisiones obreras	L_NCFP000
Comisión asesora	L_NC
Comisión de evaluación	L_NC
Comisión de gobierno	L_NC
Comisión económica	L_NC
Comisión ejecutiva	L_NC
Comisión europea	L_NCFS000
Comisión mixta	L_NC
Comisión nacional del mercado de valores	L_NCFS000
Comisión negociadora	L_NC
Comisión paritaria	L_NC
Comisión parlamentaria	L_NC
Comité central del partido	L_NCMS000
Comité económico y social	L_NCMS000
Comité ejecutivo	L_NCMS000
Comité olímpico internacional	L_NCMS000
Comité organizador	L_NCMS000
Como Pedro por su casa	L_RG
Como a los ojos de su cara	L_RG
Como a real de enemigo	L_RG
Como ahora es de día	L_RG
Como alma que lleva el diablo	L_RG
Como caído de las nubes	L_RG
Como de la noche al día	L_RG
Como dos y dos son cuatro	L_RG
Como el convidado de piedra	L_RG
Como el día a la noche	L_RG
Como el perro y el gato	L_RG
Como es de día	L_RG
Como es debido	L_RG
Como estamos aquí tú y yo	L_RG
Como está mandado	L_RG
Como hay Dios	L_RG
Como hecho de encargo	L_RG
Como la palma de la mano	L_RG
Como los chorros del oro	L_RG
Como mucho	L_RG
Como mínimo	L_RG
Como oro en paño	L_RG
Como por ensalmo	L_RG
Como que	L_CS
Como quien dice	L_RG
Como quien no quiere la cosa	L_RG
Como quien oye llover	L_RG
Como quiera que	L_CS
Como si no hubiera dicho nada	L_RG
Como si tal cosa	L_RG
Como un pepe	L_RG
Compact disc	L_NCMS000
Compañero de equipo	L_NC
Compañía aérea	L_NC
Compañía de jesús	L_NCFS000
Compensación económica	L_NC
Complejo turístico	L_NC
Comportamiento humano	L_NCMS000
Comportamiento sexual	L_NC
Comportamiento social	L_NC
Composición musical	L_NC
Comprensión lectora	L_NCFS000
Compromiso político	L_NC
Comunicación de datos	L_NCFS000
Comunicación oral	L_NCFS000
Comunicación verbal	L_NCFS000
Comunidad económica europea	L_NCFS000
Comunidad europea	L_NCFS000
Comunidad humana	L_NC
Con carácter de	L_SPS00
Con claridad meridiana	L_RG
Con conocimiento de causa	L_RG
Con creces	L_RG
Con efecto desde	L_SPS00
Con el culo al aire	L_RG
Con el ojo tan largo	L_RG
Con el sudor de la frente	L_RG
Con excepción de	L_SPS00
Con honores de	L_SPS00
Con la ayuda de Dios	L_RG
Con la boca abierta	L_RG
Con la casa a cuestas	L_RG
Con la condición de	L_SPS00
Con la espada desnuda	L_RG
Con la frente alta	L_RG
Con la frente bien alta	L_RG
Con la frente levantada	L_RG
Con la lengua de un palmo	L_RG
Con la lengua fuera	L_RG
Con la mano en el corazón	L_RG
Con la música a otra parte	L_RG
Con la soga al cuello	L_RG
Con la vida en un hilo	L_RG
Con las manos cruzadas	L_RG
Con las manos vacías	L_RG
Con las orejas caídas	L_RG
Con las orejas gachas	L_RG
Con las orejas tan largas	L_RG
Con las piernas cruzadas	L_RG
Con lo que respecta a	L_SPS00
Con los cinco sentidos	L_RG
Con los ojos cerrados	L_RG
Con los pies delante	L_RG
Con mal pie	L_RG
Con mala idea	L_RG
Con mano escasa	L_RG
Con mano pesada	L_RG
Con mil amores	L_RG
Con miquis	L_RG
Con miras a	L_SPS00
Con moto	L_RG
Con mucho gusto	L_RG
Con objeto de	L_SPS00
Con objeto que	L_CS
Con ocasión de	L_SPS00
Con pelos y señales	L_RG
Con pies de plomo	L_RG
Con puntos y comas	L_RG
Con relación a	L_SPS00
Con respecto a	L_SPS00
Con respecto de	L_SPS00
Con solo que	L_CS
Con sordina	L_RG
Con tal de	L_SPS00
Con tal de que	L_CS
Con tal que	L_CS
Con toda la barba	L_RG
Con toda la boca	L_RG
Con toda normalidad	L_RG
Con todas las de la ley	L_RG
Con todo y con eso	L_RG
Con un palmo de lengua	L_RG
Con uñas y dientes	L_RG
Con valor de	L_SPS00
Con viento fresco	L_RG
Con vistas a	L_SPS00
Con zurrapas	L_RG
Concesión administrativa	L_NC
Conciencia colectiva	L_NCFS000
Conciencia nacional	L_NCFS000
Conciencia pública	L_NCFS000
Conciencia social	L_NCFS000
Concilio vaticano II	L_NCMN000
Condiciones ambientales	L_NCFP000
Condiciones atmosféricas	L_NCFP000
Condiciones de venta	L_NCFP000
Condiciones de vida	L_NCFP000
Condiciones económicas	L_NCFP000
Condiciones generales	L_NCFP000
Conducta humana	L_NCFS000
Conexión a la red	L_NCFS000
Conferencia episcopal	L_NCFS000
Conferencia mundial	L_NCFS000
Conflicto armado	L_NC
Conflicto social	L_NC
Conforme a	L_SPS00
Congregación para la doctrina de la fe	L_NCMN000
Congreso eucarístico	L_NCMS000
Congreso nacional	L_NCMS000
Conocimiento científico	L_NCMS000
Conocimiento humano	L_NCMS000
Consecutio temporum	L_RG
Consejo de estado	L_NC
Consejo de europa	L_NCMS000
Consejo de la unión europea	L_NCMS000
Consejo de ministros	L_NC
Consejo de seguridad	L_NCMS000
Consejo de seguridad de las naciones unidas	L_NCMS000
Consejo directivo	L_NC
Consejo económico y social	L_NCMS000
Consejo ejecutivo	L_NC
Consejo municipal	L_NC
Consejo nacional	L_NC
Consejo permanente	L_NC
Conservatorio de música	L_NC
Construcción naval	L_NCFS000
Consulta popular	L_NC
Contabilidad financiera	L_NCFS000
Contaminación acústica	L_NCFS000
Contaminación ambiental	L_NCFS000
Contaminación atmosférica	L_NCFS000
Contaminación del agua	L_NCFS000
Contra reloj	L_RG
Contra rembolso	L_RG
Contra viento y marea	L_RG
Contratación de personal	L_NCFS000
Contrato de obra	L_NC
Contrato social	L_NC
Control de flujo	L_NCMS000
Control de gestión	L_NCMS000
Control médico	L_NC
Control numérico	L_NCMS000
Convención de ginebra	L_NCMS000
Convención europea	L_NC
Cooperación económica	L_NCFS000
Coordenadas geográficas	L_NCFS000
Copa de europa	L_NC
Copa intercontinental	L_NC
Corpore insepulto	L_RG
Correlación de fuerzas	L_NCFS000
Correo basura	L_NCFS000
Correo no deseado	L_NCFS000
Corte suprema	L_NCFS000
Cortes generales	L_NCFP000
Corteza cerebral	L_NCFS000
Cosa juzgada	L_NCFS000
Crecimiento de la población	L_NCMS000
Crecimiento urbano	L_NCMS000
Crisis económica	L_NC
Cruz roja	L_NCFS000
Cruz roja internacional	L_NCFS000
Crédito personal	L_NC
Cuanto antes	L_RG
Cubierta vegetal	L_NC
Cuello uterino	L_NCMS000
Cuenta de ahorro	L_NC
Cuenta de pérdidas y ganancias	L_NC
Cuenta de resultados	L_NC
Cuerpo de bomberos	L_NC
Cuerpo diplomático	L_NC
Cuerpo docente	L_NC
Cuerpo legislativo	L_NC
Cuidado médico	L_NC
Cultura clásica	L_NCFS000
Cum laude	L_AQ0CN0
Curso académico	L_NC
Curso intensivo	L_NC
Cálamo currente	L_RG
Cámara alta	L_NCFS000
Cámara baja	L_NCFS000
Cámara de representantes	L_NCFS000
Cámara web	L_NC
Código de comercio	L_NC
Código de identificación	L_NC
Código fuente	L_NCMS000
Código genético	L_NCMS000
Código ético	L_NC
Córam pópulo	L_RG
Da capo	L_RG
Dado que	L_CS
Darse de alta	L_RG
Dato económico	L_NC
Dato personal	L_NC
Datos bancario	L_NC
Daño cerebral	L_NC
Daño material	L_NC
De Dios abajo	L_RG
De a folio	L_RG
De a veras	L_RG
De acarreo	L_RG
De acuerdo con	L_SPS00
De acá para allá	L_RG
De ahí que	L_CS
De al lado de	L_SPS00
De alto copete	L_RG
De alto coturno	L_RG
De altos vuelos	L_RG
De amplio espectro	L_RG
De andar por casa	L_RG
De anequín	L_RG
De antemano	L_RG
De aquí en adelante	L_RG
De aquí para allí	L_RG
De aquí que	L_CS
De armas tomar	L_RG
De arrastre	L_RG
De arte mayor	L_RG
De arte menor	L_RG
De aúpa	L_RG
De baja estofa	L_RG
De bajo vuelo	L_RG
De balde	L_RG
De ballesta	L_RG
De barra a barra	L_RG
De boca en boca	L_RG
De bote en bote	L_RG
De bracero	L_RG
De bruces	L_RG
De buen efecto	L_RG
De buen grado	L_RG
De buen tono	L_RG
De buena cepa	L_RG
De buena familia	L_RG
De buena fe	L_RG
De buena gana	L_RG
De buena ley	L_RG
De buena ropa	L_RG
De buena voluntad	L_RG
De buenas a primeras	L_RG
De bureo	L_RG
De bóbilis	L_RG
De cabo a rabo	L_RG
De canto	L_RG
De cara a	L_SPS00
De carrerilla	L_RG
De carretilla	L_RG
De cascabel gordo	L_RG
De casquería	L_RG
De cañutillo	L_RG
De chipén	L_RG
De churro	L_RG
De ciencia cierta	L_RG
De circunvalación	L_RG
De consuno	L_RG
De corredera	L_RG
De cortos vuelos	L_RG
De coña	L_RG
De cuajo	L_RG
De cualquier forma	L_RG
De cuando en cuando	L_RG
De cuelga	L_RG
De cuenta y riesgo	L_RG
De cuerpo presente	L_RG
De cutio	L_RG
De debajo de	L_SPS00
De delante de	L_SPS00
De dentro de	L_SPS00
De detrás de	L_SPS00
De dientes afuera	L_RG
De disparo	L_RG
De doble filo	L_RG
De dos en dos	L_RG
De dos filos	L_RG
De día en día	L_RG
De ensueño	L_RG
De entonces acá	L_RG
De estampía	L_RG
De este lado de	L_SPS00
De extranjis	L_RG
De facto	L_RG
De falondres	L_RG
De fogueo	L_RG
De fuera de	L_SPS00
De golpe y porrazo	L_RG
De grado en grado	L_RG
De guagua	L_RG
De guardarropía	L_RG
De guillotina	L_RG
De higos a brevas	L_RG
De hoy en adelante	L_RG
De hoy para mañana	L_RG
De hoz y de coz	L_RG
De ida y vuelta	L_RG
De iure	L_RG
De jure	L_RG
De juro	L_RG
De la cruz a la fecha	L_RG
De la mano de	L_SPS00
De la noche a la mañana	L_RG
De la puñeta	L_RG
De la zona de	L_SPS00
De lado a lado	L_RG
De lance en lance	L_RG
De lengua en lengua	L_RG
De lo contrario	L_RG
De lo lindo	L_RG
De lo vivo a lo pintado	L_RG
De madrugada	L_RG
De mal a mal	L_RG
De mal abrigo	L_RG
De mal efecto	L_RG
De mal en peor	L_RG
De mal grado	L_RG
De mal tono	L_RG
De mal vivir	L_RG
De mala fe	L_RG
De mala gana	L_RG
De mala ley	L_RG
De mala manera	L_RG
De mala muerte	L_RG
De mala nota	L_RG
De mancomún	L_RG
De mano derecha	L_RG
De mano en mano	L_RG
De mano izquierda	L_RG
De manos a boca	L_RG
De marca mayor	L_RG
De marras	L_RG
De matute	L_RG
De media gala	L_RG
De medio a medio	L_RG
De medio lado	L_RG
De medio ojo	L_RG
De medio pie	L_RG
De mentirijillas	L_RG
De mil amores	L_RG
De mil diablos	L_RG
De miranda	L_RG
De misa y olla	L_RG
De modo que	L_CS
De momio	L_RG
De morondanga	L_RG
De muchas campanillas	L_RG
De muchas leguas	L_RG
De mucho efecto	L_RG
De mucho trote	L_RG
De más marca	L_RG
De mírame y no me toques	L_RG
De ninguna manera	L_RG
De nueva planta	L_RG
De nuevo cuño	L_RG
De nunca acabar	L_RG
De oque	L_RG
De oreja a oreja	L_RG
De oro y azul	L_RG
De oídas	L_RG
De pacotilla	L_RG
De padre y muy señor mío	L_RG
De palabra en palabra	L_RG
De pascuas a ramos	L_RG
De pe a pa	L_RG
De pega	L_RG
De pelo en pecho	L_RG
De perdidos al río	L_RG
De perilla	L_RG
De perillas	L_RG
De persona a persona	L_RG
De pie de banco	L_RG
De pies a cabeza	L_RG
De pilón	L_RG
De pitiminí	L_RG
De pleno derecho	L_RG
De poca monta	L_RG
De poca ropa	L_RG
De poco más o menos	L_RG
De poco pelo	L_RG
De poder a poder	L_RG
De polo a polo	L_RG
De pontifical	L_RG
De popa a proa	L_RG
De por junto	L_RG
De por medio	L_RG
De por sí	L_RG
De por vida	L_RG
De postín	L_RG
De potencia en potencia	L_RG
De primera clase	L_RG
De primera intención	L_RG
De primera línea	L_RG
De prisa	L_RG
De prisa y corriendo	L_RG
De pro	L_RG
De propia minerva	L_RG
De propio puño	L_RG
De puerta a puerta	L_RG
De puerta en puerta	L_RG
De puertas adentro	L_RG
De puertas afuera	L_RG
De puertos allende	L_RG
De puertos aquende	L_RG
De punta a cabo	L_RG
De punta a punta	L_RG
De pura cepa	L_RG
De puta madre	L_RG
De puta pena	L_RG
De putifa	L_RG
De puño y letra	L_RG
De quedo	L_RG
De quita y pon	L_RG
De rama en rama	L_RG
De raro en raro	L_RG
De rato en rato	L_RG
De rebato	L_RG
De rebote	L_RG
De rechupete	L_RG
De refilón	L_RG
De relumbrón	L_RG
De repelón	L_RG
De repente	L_RG
De repuesto	L_RG
De reserva	L_RG
De resultas	L_RG
De retrocarga	L_RG
De revuelo	L_RG
De rodilla en rodilla	L_RG
De rompe y rasga	L_RG
De rondón	L_RG
De seguida	L_RG
De segunda mano	L_RG
De sentido común	L_RG
De so capa	L_RG
De sobra	L_RG
De sobresalto	L_RG
De sol a sol	L_RG
De soslayo	L_RG
De suerte que	L_CS
De tal manera que	L_CS
De tapadillo	L_RG
De tarde en tarde	L_RG
De tiempo en tiempo	L_RG
De tiento en tiento	L_RG
De todas maneras	L_RG
De todas todas	L_RG
De todo corazón	L_RG
De todo en todo	L_RG
De todo punto	L_RG
De todos los diablos	L_RG
De todos modos	L_RG
De través	L_RG
De trazo continuo	L_RG
De trecho en trecho	L_RG
De tres al cuarto	L_RG
De tú a tú	L_RG
De ultratumba	L_RG
De un día a otro	L_RG
De un jalón	L_RG
De un lado a otro	L_RG
De un lado para otro	L_RG
De un plumazo	L_RG
De un primer voleo	L_RG
De un tirón	L_RG
De una manera o de otra	L_RG
De una sentada	L_RG
De una tacada	L_RG
De una tirada	L_RG
De una vez para siempre	L_RG
De uno en uno	L_RG
De uso externo	L_RG
De uvas a peras	L_RG
De vez en cuando	L_RG
De visu	L_RG
De viva voz	L_RG
De volatería	L_RG
De vértigo	L_RG
De vía estrecha	L_RG
De órdago	L_RG
Debajo de	L_SPS00
Debate parlamentario	L_NC
Debido a	L_SPS00
Declaración de guerra	L_NCFS000
Declaración de principios	L_NCFS000
Declaración jurada	L_NC
Decreto ley	L_NC
Del otro lado	L_RG
Del otro lado de	L_SPS00
Del poder de	L_SPS00
Del primer voleo	L_RG
Del principio al fin	L_RG
Del revés	L_RG
Del tiempo de Maricastaña	L_RG
Delante de	L_SPS00
Delante de Dios y de todo el	L_RG
Delegación territorial	L_NC
Delito doloso	L_NCMS000
Demanda agregada	L_NCFS000
Demanda de empleo	L_NC
Demandante de empleo	L_NC
Democracia participativa	L_NCFS000
Denominación social	L_NCFS000
Deo gracias	L_I
Deo volente	L_RG
Departamento de agricultura	L_NCMS000
Departamento de educación	L_NCMS000
Departamento de industria , comercio y turismo	L_NCMS000
Departamento de justicia	L_NCMS000
Departamento de medio ambiente	L_NCMS000
Dependencia económica	L_NCFS000
Deporte de aventura	L_NC
Deporte profesional	L_NCMS000
Depuración de aguas	L_NCMS000
Depuración de aguas residuales	L_NCMS000
Derecho a participar	L_NCMS000
Derecho adquirido	L_NC
Derecho civil	L_NC
Derecho de asociación	L_NCMS000
Derecho de autodeterminación	L_NCMS000
Derecho de familia	L_NCMS000
Derecho de huelga	L_NCMS000
Derecho de petición	L_NCMS000
Derecho de uso	L_NCMS000
Derecho de voto	L_NCMS000
Derecho del hombre	L_NC
Derecho fiscal	L_NCMS000
Derecho fundamental	L_NC
Derecho humano	L_NC
Derecho individual	L_NCMS000
Derecho nacional	L_NCMS000
Derecho natural	L_NCMS000
Derecho político	L_NC
Derecho positivo	L_NCMS000
Derecho privado	L_NCMS000
Derecho público	L_NCMS000
Derecho subjetivo	L_NCMS000
Derecho tributario	L_NCMS000
Desarrollo de la personalidad	L_NCMS000
Desarrollo económico	L_NCMS000
Desarrollo rural	L_NCMS000
Desarrollo urbano	L_NCMS000
Desastre ecológico	L_NC
Desastre natural	L_NC
Descarga eléctrica	L_NC
Desde cero	L_RG
Desde el momento en que	L_CS
Desde luego	L_RG
Desde niño	L_RG
Desde que el mundo es mundo	L_RG
Detrás de	L_SPS00
Diagnóstico clínico	L_NC
Diagnóstico médico	L_NC
Diagnóstico precoz	L_NC
Diario oficial de la unión europea	L_NCMS000
Dibujo animado	L_NC
Dictadura militar	L_NC
Dieta equilibrada	L_NC
Dietética y nutrición	L_NCMS000
Dignidad humana	L_NCFS000
Dirección a	L_SPS00
Dirección administrativa	L_NCFS000
Dirección de recursos humanos	L_NCFS000
Dirección del viento	L_NCFS000
Dirección general	L_NCFS000
Dirección general de carreteras	L_NCFS000
Dirección general de cultura	L_NCFS000
Dirección general de los registros y del notariado	L_NCFS000
Dirección general de seguros	L_NCFS000
Dirección general de servicios	L_NCFS000
Dirección general de tráfico	L_NCFS000
Dirección ip	L_NCFS000
Dirección url	L_NCFS000
Director adjunto	L_NC
Director administrativo	L_NC
Director artístico	L_NC
Director de fotografía	L_NC
Director de orquesta	L_NC
Director general	L_NC
Director gerente	L_NC
Director técnico	L_NC
Directorio raíz	L_NCFS000
Disc jockey	L_NCFS000
Diseño asistido por ordenador	L_NCMS000
Diseño editorial	L_NCMS000
Diseño industrial	L_NCMS000
Disfunción eréctil	L_NC
Disposición legal	L_NC
Distribución espacial	L_NCFS000
Distribución geográfica	L_NCFS000
Distribución normal	L_NCFS000
Distrito electoral	L_NC
Diversidad biológica	L_NCFS000
División de poderes	L_NCFS000
Dióxido de azufre	L_NCFS000
Dióxido de carbono	L_NCFS000
Do ut des	L_RG
Doble imposición	L_NCCS000
Doble nacionalidad	L_NCCS000
Doctor en derecho	L_NC
Documentación administrativa	L_NCFS000
Documento de identidad	L_NC
Documento html	L_NCMS000
Dolor de cabeza	L_NC
Domiciliación bancaria	L_NC
Domicilio legal	L_NCMS000
Domicilio social	L_NCMS000
Dotación presupuestaria	L_NC
Droga ilícita	L_NC
Duración del contrato	L_NCFS000
Duty free	L_AQ0CN0
Día de acción de gracias	L_NCMS000
Día de descanso	L_NC
Día de fiesta	L_NC
Eclipse total	L_NC
Economía aplicada	L_NCFS000
Economía de escala	L_NC
Economía de la salud	L_NCFS000
Economía doméstica	L_NCFS000
Economía española	L_NCFS000
Economía familiar	L_NCFS000
Economía general	L_NCFS000
Economía informal	L_NCFS000
Economía internacional	L_NCFS000
Economía mixta	L_NCFS000
Economía mundial	L_NCFS000
Economía nacional	L_NCFS000
Economía política	L_NCFS000
Economía regional	L_NCFS000
Economía social	L_NCFS000
Edad adulta	L_NCFS000
Edad de jubilación	L_NCFS000
Edad de oro	L_NCFS000
Edad escolar	L_NCFS000
Edad media	L_NC
Edición limitada	L_NC
Edificio central	L_NC
Edificio principal	L_NC
Educación ambiental	L_NCFS000
Educación artística	L_NCFS000
Educación de adultos	L_NCFS000
Educación escolar	L_NCFS000
Educación formal	L_NCFS000
Educación general básica	L_NCFS000
Educación infantil	L_NCFS000
Educación infantil y primaria	L_NCFS000
Educación intercultural	L_NCFS000
Educación obligatoria	L_NCFS000
Educación para el desarrollo	L_NCFS000
Educación para la salud	L_NCFS000
Educación preescolar	L_NCFS000
Educación primaria	L_NCFS000
Educación religiosa	L_NCFS000
Educación sanitaria	L_NCFS000
Educación secundaria	L_NCFS000
Educación secundaria obligatoria	L_NCFS000
Educación sexual	L_NCFS000
Educación vial	L_NCFS000
Efecto directo	L_NC
Efecto especial	L_NC
Eje principal	L_NC
Eje y	L_NCMS000
Ejecución de sentencia	L_NCFS000
Ejercicio económico	L_NC
Ejercicio físico	L_NC
Ejército de liberación	L_NCMS000
Ejército de liberación nacional	L_NCMS000
Ejército de tierra	L_NCMS000
Ejército nacional	L_NCMS000
Ejército popular	L_NCMS000
Ejército zapatista de liberación nacional	L_NCMS000
Elecciones al parlamento europeo	L_NCFP000
Elecciones libres	L_NCFP000
Elecciones parlamentarias	L_NCFP000
Elección presidencial	L_NCFS000
Eliminación de residuos	L_NCFS000
Emergencia social	L_NC
Emisión de bonos	L_NC
Emisión de gases	L_NC
Empleo estable	L_NC
Empresa comercial	L_NC
Empresa constructora	L_NC
Empresa de servicios	L_NC
Empresa de transporte	L_NC
Empresa estatal	L_NC
Empresa familiar	L_NC
Empresa industrial	L_NC
Empresa multinacional	L_NC
Empresa privada	L_NC
Empresa pública	L_NC
En Dios y en conciencia	L_RG
En agraz	L_RG
En aquel entonces	L_RG
En aras de	L_SPS00
En atención a	L_SPS00
En babia	L_RG
En batería	L_RG
En berlina	L_RG
En buena lid	L_RG
En buenos términos	L_RG
En busca de	L_SPS00
En calidad de	L_SPS00
En cambio de	L_SPS00
En caso de	L_SPS00
En caso de que	L_CS
En cierto modo	L_RG
En compañía de	L_SPS00
En compensación de	L_SPS00
En concepto de	L_SPS00
En consecuencia	L_RG
En contorno	L_RG
En contra de	L_SPS00
En contracambio	L_RG
En coña	L_RG
En cuanto a	L_SPS00
En cuanto que	L_CS
En cuclillas	L_RG
En cuerpo y alma	L_RG
En cuestión de	L_SPS00
En círculo	L_RG
En defecto de	L_SPS00
En demanda de	L_SPS00
En demasía	L_RG
En derredor de	L_SPS00
En desbandada	L_RG
En descargo	L_RG
En desquite	L_RG
En detalle	L_RG
En diferido	L_RG
En dirección a	L_SPS00
En el centro de	L_SPS00
En el entorno de	L_SPS00
En el interior de	L_SPS00
En el otro lado de	L_SPS00
En el plazo de	L_SPS00
En el puesto de	L_SPS00
En el supuesto que	L_CS
En entredicho	L_RG
En espera de	L_SPS00
En este mismo instante	L_RG
En evitación de	L_SPS00
En favor de	L_SPS00
En fiado	L_RG
En fila india	L_RG
En fin de cuentas	L_RG
En franquía	L_RG
En gracia a	L_SPS00
En gran manera	L_RG
En gran medida	L_RG
En guisa de	L_SPS00
En honor a la verdad	L_RG
En horre	L_RG
En interés	L_RG
En junto	L_RG
En la línea de	L_SPS00
En la necesidad de	L_SPS00
En la temporada de	L_SPS00
En la zona de	L_SPS00
En las cercanías de	L_SPS00
En las proximidades de	L_SPS00
En limpio	L_RG
En lo concerniente a	L_SPS00
En lo sucesivo	L_RG
En lontananza	L_RG
En los buenos tiempos	L_RG
En lugar de	L_SPS00
En lugar de que	L_CS
En línea	L_RG
En líneas generales	L_RG
En mala hora	L_RG
En mangas de camisa	L_RG
En manos de	L_SPS00
En materia de	L_SPS00
En medio de	L_SPS00
En memoria de	L_SPS00
En menos de	L_SPS00
En miniatura	L_RG
En mitad de	L_SPS00
En modo alguno	L_RG
En obligación de	L_SPS00
En obsequio a	L_SPS00
En obsequio de	L_SPS00
En oferta	L_RG
En oposición a	L_SPS00
En orden a	L_SPS00
En paralelo	L_RG
En parte por	L_SPS00
En partes iguales	L_RG
En paños menores	L_RG
En pelota picada	L_RG
En pie de guerra	L_RG
En plan de	L_SPS00
En plantilla	L_RG
En pocas palabras	L_RG
En porretas	L_RG
En pos de	L_SPS00
En prenda	L_RG
En primicia	L_RG
En pro de	L_SPS00
En procura	L_RG
En prueba de	L_SPS00
En punto de caramelo	L_RG
En puridad	L_RG
En rama	L_RG
En razón de	L_SPS00
En recuerdo de	L_SPS00
En rededor	L_RG
En remojo	L_RG
En representación de	L_SPS00
En resumidas cuentas	L_RG
En ristre	L_RG
En salvo	L_RG
En seguida	L_RG
En señal de	L_SPS00
En sordina	L_RG
En su defecto	L_RG
En tanto que	L_CS
En tiempo de	L_SPS00
En tiempo diferido	L_RG
En tiempo real	L_RG
En tiempo récord	L_RG
En tiempo y forma	L_RG
En toda la extensión de la palabra	L_RG
En toda regla	L_RG
En toda tierra de garbanzos	L_RG
En todo caso	L_RG
En todo lo descubierto	L_RG
En torno a	L_SPS00
En torno de	L_SPS00
En touche	L_RG
En tromba	L_RG
En tándem	L_RG
En un abrir y cerrar de ojos	L_RG
En un decir amén	L_RG
En un pis-pas	L_RG
En un pispás	L_RG
En un tris	L_RG
En vez de	L_SPS00
En vez de que	L_CS
En vilo	L_RG
En virtud de	L_SPS00
En vista de	L_SPS00
En vista de que	L_CS
En volandas	L_RG
En vías de	L_SPS00
En zigzag	L_RG
Encefalopatía espongiforme bovina	L_NCFS000
Encima de	L_SPS00
Encuesta de opinión	L_NC
Endocrinología y nutrición	L_NCFS000
Energía eólica	L_NCFS000
Energía térmica	L_NCFS000
Enfermedad grave	L_NC
Enfermedad profesional	L_NC
Enfrente de	L_SPS00
Ensayo clínico	L_NC
Enseñanza básica	L_NCFS000
Enseñanza de idiomas	L_NCFS000
Enseñanza media	L_NCFS000
Ente público	L_NCFS000
Entidad gestora	L_NCFS000
Entidad pública	L_NCFS000
Entorno de red	L_NCMS000
Entorno social	L_NCMS000
Entrada gratuita	L_NCFS000
Entre la espada y la pared	L_RG
Entre la vida y la muerte	L_RG
Entre pecho y espalda	L_RG
Entre que	L_CS
Entre tanto que	L_CS
Entrega de premios	L_NC
Entrenamiento físico	L_NCMS000
Equilibrio ecológico	L_NCMS000
Equipo de fútbol	L_NC
Equipo de protección	L_NC
Equipo de sonido	L_NC
Equipo directivo	L_NC
Equipo docente	L_NC
Equipo informático	L_NC
Equipo nacional	L_NC
Erario público	L_NCMS000
Es hablar por demás	L_RG
Escala de valores	L_NC
Esclerosis múltiple	L_NCMS000
Escuela de arte	L_NC
Escuela de bellas artes	L_NC
Escuela de música	L_NC
Escuela oficial de idiomas	L_NCFS000
Escuela rural	L_NC
Escuela taller	L_NC
Espacio económico europeo	L_NCMS000
Espacio en blanco	L_NC
Especie humana	L_NCFS000
Esperando a	L_SPS00
Estabilidad económica	L_NCFS000
Estabilidad política	L_NCFS000
Estación de autobús	L_NC
Estación de ferrocarril	L_NC
Estación de tren	L_NC
Estación meteorológica	L_NC
Estadio olímpico	L_NC
Estado anímico	L_NCMS000
Estado de salud	L_NCMS000
Estado del bienestar	L_NCMS000
Estado democrático	L_NC
Estado emocional	L_NCMS000
Estado federal	L_NC
Estado independiente	L_NC
Estado miembro de la unión europea	L_NC
Estado nacional	L_NC
Estado sólido	L_NCMS000
Estadística descriptiva	L_NCFS000
Estatutos sociales	L_NCMP000
Estructura de datos	L_NC
Estructura económica	L_NCFS000
Estructura familiar	L_NC
Estructura jerárquica	L_NCFS000
Estructura social	L_NCFS000
Estudio de grabación	L_NC
Estudio de impacto	L_NC
Estudio económico	L_NC
Estudios empresariales	L_NCMP000
Evaluación continua	L_NC
Evaluación del impacto ambiental	L_NC
Evaluación del riesgo	L_NC
Evaluación externa	L_NC
Evidencia científica	L_NC
Ex abrupto	L_RG
Ex aequo	L_RG
Ex ante	L_AQ0CN0
Ex cathedra	L_RG
Ex cáthedra	L_RG
Ex post	L_AQ0CN0
Ex profeso	L_RG
Ex testamento	L_RG
Excepto que	L_CS
Exceso de velocidad	L_NC
Expansión económica	L_NCFS000
Expediente disciplinario	L_NC
Explotación agrícola	L_NC
Exposición itinerante	L_NC
Exposición permanente	L_NC
Expresión artística	L_NCFS000
Expresión escrita	L_NCFS000
Expresión oral	L_NCFS000
Expresión plástica	L_NCFS000
Extrema derecha	L_NCFS000
Factor ambiental	L_NC
Factor de riesgo	L_NC
Facultad de bellas artes	L_NCFS000
Facultad de derecho	L_NCFS000
Facultad de psicología	L_NCFS000
Fal Fh s	L_NCFS000
Falso testimonio	L_NC
Farmacología clínica	L_NCFS000
Fauna marina	L_NCFS000
Fe cristiana	L_NCFS000
Fecha de cierre	L_NC
Fecha de emisión	L_NC
Fecha de solicitud	L_NC
Fecha límite	L_NC
Fecha tope	L_NC
Federación nacional	L_NC
Ficha técnica	L_NC
Fichero de datos	L_NC
Figura jurídica	L_NC
Filología clásica	L_NCFS000
Filosofía de la ciencia	L_NCFS000
Filosofía del derecho	L_NCFS000
Filosofía política	L_NCFS000
Final feliz	L_NC
Fiscal jefe	L_NC
Flujo de aire	L_NCFS000
Flujo de caja	L_NCFS000
Flujo de datos	L_NCFS000
Flujo de fondos	L_NCFS000
Flujo de información	L_NCFS000
Fondo de garantía	L_NC
Fondo de pensiones	L_NC
Fondo documental	L_NC
Fondo europeo de desarrollo	L_NCMS000
Fondo monetario internacional	L_NCMS000
Fondo social europeo	L_NCMS000
Forma gráfica	L_NC
Formación humana	L_NCFS000
Formación ocupacional	L_NCFS000
Formación profesional específica	L_NCFS000
Formación profesional ocupacional	L_NCFS000
Formato html	L_NCFS000
Fosa nasal	L_NC
Fotografía aérea	L_NCFS000
Frame relay	L_NCFS000
Frecuencia cardiaca	L_NC
Frente nacional	L_NCFS000
Frente popular	L_NCFS000
Fruta fresca	L_NCFS000
Fruto seco	L_NC
Ft Fh h	L_NCFS000
Ft Fh min	L_NCFS000
Ft Fh s	L_NCFS000
Ft Fh s2	L_NCFS000
Ft3 Fh min	L_NCFS000
Ft3 Fh s	L_NCFS000
Fuente de alimentación	L_NC
Fuente de datos	L_NC
Fuente de energía	L_NC
Fuente de financiación	L_NC
Fuente de luz	L_NC
Fuera de que	L_CS
Fuerza física	L_NCFS000
Fuerza militar	L_NCFS000
Fuerzas de ocupación	L_NCFP000
Fuerzas de seguridad	L_NCFP000
Fuerzas y cuerpos de seguridad	L_NCFP000
Fuga de capitales	L_NCFS000
Full time	L_AQ0CN0
Full time	L_RG
Función administrativa	L_NC
Fundamento jurídico	L_NC
Fundamentos de derecho	L_NCMP000
Física aplicada	L_NCFS000
Física nuclear	L_NCFS000
Física teórica	L_NCFS000
Fútbol base	L_NCMS000
G Fh l	L_NCMP000
G Fh m3	L_NCMP000
Gabinete técnico	L_NC
Gal Fh ac Fh d	L_NCFS000
Gal Fh cap Fh d	L_NCFS000
Gal Fh d	L_NCFS000
Gal Fh ft2	L_NCFS000
Gal Fh ft2 Fh min	L_NCFS000
Gal Fh ft2 d	L_NCFS000
Gal Fh h	L_NCFS000
Gal Fh min	L_NCFS000
Galería comercial	L_NC
Galón Fh acre Fh día	L_NC
Galón Fh acre día	L_NC
Galón Fh acre por día	L_NC
Galón Fh cápita Fh día	L_NC
Galón Fh cápita día	L_NC
Galón Fh cápita por día	L_NC
Galón Fh día	L_NC
Galón Fh hora	L_NC
Galón Fh minuto	L_NC
Galón Fh pie cuadrado	L_NC
Galón Fh pie cuadrado Fh día	L_NC
Galón Fh pie cuadrado Fh minuto	L_NC
Galón Fh pie cuadrado día	L_NC
Galón Fh pie cuadrado minuto	L_NC
Galón Fh pie cuadrado por día	L_NC
Galón Fh pie cuadrado por minuto	L_NC
Galón Fh segundo	L_NC
Galón acre Fh día	L_NC
Galón acre por día	L_NC
Galón cápita Fh día	L_NC
Galón cápita por día	L_NC
Galón día	L_NC
Galón hora	L_NC
Galón minuto	L_NC
Galón per cápita Fh día	L_NC
Galón per cápita día	L_NC
Galón per cápita por día	L_NC
Galón pie cuadrado Fh día	L_NC
Galón pie cuadrado Fh minuto	L_NC
Galón pie cuadrado por día	L_NC
Galón pie cuadrado por minuto	L_NC
Galón por acre Fh día	L_NC
Galón por acre día	L_NC
Galón por acre por día	L_NC
Galón por acre y día	L_NC
Galón por cápita Fh día	L_NC
Galón por cápita día	L_NC
Galón por cápita por día	L_NC
Galón por día	L_NC
Galón por hora	L_NC
Galón por minuto	L_NC
Galón por pie cuadrado	L_NC
Galón por pie cuadrado Fh día	L_NC
Galón por pie cuadrado Fh minuto	L_NC
Galón por pie cuadrado día	L_NC
Galón por pie cuadrado minuto	L_NC
Galón por pie cuadrado por día	L_NC
Galón por pie cuadrado por minuto	L_NC
Galón por pie cuadrado y día	L_NC
Galón por pie cuadrado y minuto	L_NC
Galón por segundo	L_NC
Galón segundo	L_NC
Gama de productos	L_NC
Ganancia neta	L_NC
Garantía constitucional	L_NCFS000
Garantía hipotecaria	L_NCFS000
Gastos corrientes	L_NCMP000
Gastos de administración	L_NCMP000
Gastos de capital	L_NCMP000
Gastos de funcionamiento	L_NCMP000
Gastos de gestión	L_NCMP000
Gastos de mantenimiento	L_NCMP000
Gastos de personal	L_NCMP000
Gastos de transporte	L_NCMP000
Gastos de viaje	L_NCMP000
Gastos fijos	L_NCMP000
Gastos financieros	L_NCMP000
Gastos públicos	L_NCMP000
Gastos sociales	L_NCMP000
Geografía física	L_NCFS000
Geografía humana	L_NCFS000
Geometría analítica	L_NCFS000
Gestión administrativa	L_NCFS000
Gestión clínica	L_NCFS000
Gestión de datos	L_NCFS000
Gestión de la empresa	L_NCFS000
Gestión de personal	L_NCFS000
Gestión económica	L_NCFS000
Gestión educativa	L_NCFS000
Gestión empresarial	L_NCFS000
Gestión interna	L_NCFS000
Gestión medioambiental	L_NCFS000
Gestión sanitaria	L_NCFS000
Gestión urbanística	L_NCFS000
Gimnasia artística	L_NCFS000
Giro postal	L_NC
Globalización de la economía	L_NCFS000
Gobierno central	L_NCMS000
Gobierno civil	L_NCMS000
Gobierno constitucional	L_NCMS000
Gobierno federal	L_NCMS000
Gobierno local	L_NCMS000
Gobierno militar	L_NCMS000
Gobierno provisional	L_NCMS000
Gobierno revolucionario	L_NCMS000
Golpe militar	L_NC
Gracia de dios	L_NCFS000
Gracias a	L_SPS00
Gracias a que	L_CS
Gracias al que	L_CS
Grado celsius	L_NC
Grado centígrado	L_NC
Grado de madurez	L_NCMS000
Grado farenheit	L_NC
Grado kelvin	L_NC
Gramo Fh litro	L_NC
Gramo Fh metro cúbico	L_NC
Gramo por litro	L_NC
Gramo por metro cúbico	L_NC
Gripe aviar	L_NCFS000
Grosso modo	L_RG
Grupo de edad	L_NC
Grupo de empresas	L_NC
Grupo de noticias	L_NC
Grupo de trabajo	L_NC
Grupo social	L_NC
Guardería infantil	L_NC
Guardia civil	L_NC
Guardia nacional	L_NC
Guerra civil española	L_NCFS000
Guerra fría	L_NC
Guerra mundial	L_NC
Guía de turismo	L_NC
Guía didáctica	L_NC
Género literario	L_NC
Hab Fh km	L_NCFS000
Habitación doble	L_NC
Habitación individual	L_NC
Habitante Fh km2	L_NC
Habitante Fh kms2	L_NC
Habitante por kilómetro cuadrado	L_NC
Habitante por km2	L_NC
Hacia mediados de	L_SPS00
Hacienda pública	L_NCFS000
Hasta cierto punto	L_RG
Hasta cuando	L_CS
Hasta más ver	L_RG
Hasta tanto que	L_CS
Hecho imponible	L_NCMS000
Hechos de los apóstoles	L_NCMP000
Herramientas de gestión	L_NCFP000
Hic et nunc	L_RG
High tech	L_AQ0CN0
Higiene bucal	L_NCFP000
Hijo pródigo	L_NC
Hipótesis de trabajo	L_NCFN000
Historia clínica	L_NC
Historia de la educación	L_NCFS000
Historia de la filosofía	L_NCFS000
Historia del arte	L_NCFS000
Historia económica	L_NCFS000
Hoja de papel	L_NC
Hoja informativa	L_NC
Honoris causa	L_AQ0CN0
Horario de atención al público	L_NCMS000
Horario de clases	L_NCMS000
Horario de mañana	L_NCMS000
Horario de verano	L_NCMS000
Horario laboral	L_NCMS000
Horas de oficina	L_NCFP000
Horas de sol	L_NCFP000
Horas hábiles	L_NCFP000
Horno microondas	L_NC
Hospital general	L_NCMS000
Hospital infantil	L_NC
Huella digital	L_NC
Humanidades y ciencias sociales	L_NCFP000
Humedad relativa	L_NCFS000
Hábito alimentario	L_NC
Id. de usuario	L_NCMS000
Identidad nacional	L_NC
Identidad sexual	L_NCFS000
Iglesia anglicana	L_NCFS000
Iglesia católica	L_NCFS000
Iglesia evangélica	L_NCFS000
Iglesia ortodoxa	L_NCFS000
Iglesia universal	L_NCFS000
Igualdad de derechos	L_NCFS000
Igualdad de oportunidades	L_NCFS000
Igualdad entre hombres y mujeres	L_NCFS000
Igualdad social	L_NCFS000
Imagen de marca	L_NCFS000
Imagen personal	L_NCFS000
Impacto ambiental	L_NC
Impacto medioambiental	L_NC
Impacto visual	L_NC
Imperio de la ley	L_NCMS000
Impreso de solicitud	L_NC
Impuesto de sociedades	L_NCMS000
Impuesto sobre actividades económicas	L_NCMS000
Impuesto sobre bienes inmuebles	L_NCMS000
Impuesto sobre el valor añadido	L_NCMS000
Impuesto sobre la renta	L_NCMS000
Impuesto sobre la renta de las personas físicas	L_NCMS000
Impuesto sobre sociedades	L_NCMS000
Impuesto sobre transmisiones patrimoniales	L_NCMS000
In Fh s2	L_NCFS000
In aeternum	L_RG
In albis	L_RG
In artículo mortis	L_RG
In crescendo	L_RG
In extenso	L_RG
In extremis	L_RG
In fieri	L_RG
In fraganti	L_RG
In illo tempore	L_RG
In illo témpore	L_RG
In memóriam	L_RG
In partibus	L_AQ0CN0
In pectore	L_RG
In perpétuum	L_RG
In promptu	L_RG
In pártibus infidélium	L_RG
In péctore	L_RG
In púribus	L_RG
In situ	L_RG
In sólidum	L_RG
In vitro	L_AQ0CN0
In vitro	L_RG
In vivo	L_AQ0CN0
In vivo	L_RG
In ánima vili	L_RG
Incapacidad laboral	L_NCFS000
Incapacidad permanente	L_NCFS000
Incapacidad temporal	L_NCFS000
Incontinencia urinaria	L_NCFS000
Incremento salarial	L_NC
Industria nacional	L_NCFS000
Industria química	L_NCFS000
Influencia política	L_NCFS000
Información adicional	L_NCFS000
Información general	L_NCFS000
Información genética	L_NCFS000
Información tecnológica	L_NCFS000
Información turística	L_NCFS000
Informe de auditoría	L_NC
Informe de evaluación	L_NC
Informe de gestión	L_NC
Informática de gestión	L_NCFS000
Ingeniero agrónomo	L_NC
Ingeniero químico	L_NC
Ingeniero técnico agrícola	L_NC
Ingeniería química	L_NCMS000
Iniciativa legislativa	L_NC
Inmediatamente después de	L_SPS00
Inspector general	L_NC
Instituto nacional de empleo	L_NCMS000
Instituto nacional de la salud	L_NCMS000
Instituto nacional de la seguridad social	L_NCMS000
Instituto nacional de meteorología	L_NCMS000
Instrucciones de uso	L_NCFP000
Instrumento musical	L_NC
Integración económica	L_NCFS000
Integración social	L_NCFS000
Inteligencia humana	L_NCFS000
Inter nos	L_RG
Inter vivos	L_RG
Interacción social	L_NCFS000
Intercambio de datos	L_NCMS000
Interfaz de usuario	L_NC
Intervalo de tiempo	L_NC
Intervención quirúrgica	L_NC
Interés social	L_NCMS000
Investigación clínica	L_NCFS000
Ipso facto	L_RG
Ipso jure	L_RG
J Fh K	L_NCFS000
J Fh K	L_NCFS000
Jefe de gabinete	L_NC
Jefe de proyecto	L_NC
Jefe de seguridad	L_NC
Jefe de unidad	L_NC
Jefe militar	L_NC
Joule Fh K	L_NC
Joule Fh grado kelvin	L_NC
Joule Fh kelvin	L_NC
Joule por grado kelvin	L_NC
Joule por kelvin	L_NC
Jubilación anticipada	L_NC
Juego de mesa	L_NC
Juegos olímpicos	L_NCMP000
Juicio oral	L_NC
Junta general de accionistas	L_NCFS000
Junta militar	L_NCFS000
Junto a	L_SPS00
Junto con	L_SPS00
Jurisdicción contencioso-administrativa	L_NCFS000
Jurisdicción ordinaria	L_NCFS000
Jurisdicción penal	L_NCFS000
Juro a bríos	L_RG
Justicia ordinaria	L_NCFS000
Justicia social	L_NCFS000
Kg Fh cm2	L_NCMP000
Kg Fh m2	L_NCMP000
Kg Fh m3	L_NCMP000
Kg Fh s	L_NCFS000
Kilogramo Fh centímetro cuadrado	L_NC
Kilogramo Fh metro cuadrado	L_NC
Kilogramo Fh metro cúbico	L_NC
Kilogramo Fh segundo	L_NC
Kilogramo por centímetro cuadrado	L_NC
Kilogramo por metro cuadrado	L_NC
Kilogramo por metro cúbico	L_NC
Kilogramo por segundo	L_NC
Kilómetro Fh h	L_NC
Kilómetro Fh h Fh s	L_NC
Kilómetro Fh hora	L_NC
Kilómetro Fh hora Fh segundo	L_NC
Kilómetro Fh hora por segundo	L_NC
Kilómetro Fh hora segundo	L_NC
Kilómetro Fh s	L_NC
Kilómetro Fh segundo	L_NC
Kilómetro cuadrado	L_NC
Kilómetro hora Fh segundo	L_NC
Kilómetro hora por segundo	L_NC
Kilómetro hora segundo	L_NC
Kilómetro por hora	L_NC
Kilómetro por hora Fh segundo	L_NC
Kilómetro por hora por segundo	L_NC
Kilómetro por segundo	L_NC
Kilómetro segundo	L_NC
Km Fh h	L_NCFS000
Km Fh h Fh s	L_NCFS000
Kn Fh s	L_NCFS000
L Fh d	L_NCFS000
L Fh día	L_NCFS000
L Fh m2	L_NCFS000
L Fh m2 Fh d	L_NCFS000
L Fh m2 Fh min	L_NCFS000
L Fh m2 Fh s	L_NCFS000
L Fh min	L_NCFS000
L Fh s	L_NCFS000
La madre tierra	L_NCMS000
Labor docente	L_NCFS000
Laboratorio clínico	L_NC
Lactancia materna	L_NCFS000
Laudo arbitral	L_NCFS000
Lb Fh ft2	L_NCFP000
Lb Fh ft3	L_NCFP000
Lb Fh in2	L_NCFP000
Lb Fh milgal	L_NCFP000
Leche de vaca	L_NCFS000
Lector de cd	L_NC
Legislación autonómica	L_NC
Legislación nacional	L_NC
Legislación vigente	L_NC
Legítima defensa	L_NCFS000
Lejos de	L_SPS00
Lengua extranjera	L_NC
Lengua internacional	L_NC
Lengua oficial	L_NC
Lenguaje corporal	L_NCMS000
Lenguaje de programación	L_NC
Lenguaje escrito	L_NCMS000
Lenguaje oral	L_NCMS000
Ley de procedimiento administrativo	L_NCFS000
Ley del suelo	L_NCFS000
Ley fundamental	L_NCFS000
Ley general	L_NCFS000
Ley general de educación	L_NCFS000
Ley general presupuestaria	L_NCFS000
Ley general tributaria	L_NCFS000
Ley marco	L_NCFS000
Ley orgánica del poder judicial	L_NCFS000
Ley vigente	L_NC
Libertad de asociación	L_NCFS000
Libertad de expresión	L_NCFS000
Libertad de opinión	L_NCFS000
Libertad de pensamiento	L_NCFS000
Libertad de prensa	L_NCFS000
Libertad religiosa	L_NCFS000
Libertades fundamentales	L_NCFP000
Libra Fh milgalón	L_NC
Libra Fh pie cuadrado	L_NC
Libra Fh pie cúbico	L_NC
Libra Fh pulgada cuadrada	L_NC
Libra fuerza	L_NC
Libra milgalón	L_NC
Libra por milgalón	L_NC
Libra por pie cuadrado	L_NC
Libra por pie cúbico	L_NC
Libra por pulgada cuadrada	L_NC
Licencia de obras	L_NC
Liga árabe	L_NCFS000
Literatura juvenil	L_NCFS000
Litro Fh día Fh cápita	L_NC
Litro Fh día por cápita	L_NC
Litro Fh metro cuadrado	L_NC
Litro Fh metro cuadrado Fh dia	L_NC
Litro Fh metro cuadrado Fh minuto	L_NC
Litro Fh metro cuadrado Fh segundo	L_NC
Litro Fh metro cuadrado por dia	L_NC
Litro Fh metro cuadrado por minuto	L_NC
Litro Fh metro cuadrado por segundo	L_NC
Litro Fh minuto	L_NC
Litro Fh segundo	L_NC
Litro día cápita	L_NC
Litro día per cápita	L_NC
Litro día por cápita	L_NC
Litro metro cuadrado por día	L_NC
Litro metro cuadrado por minuto	L_NC
Litro metro cuadrado por segundo	L_NC
Litro por día	L_NC
Litro por día Fh cápita	L_NC
Litro por día cápita	L_NC
Litro por día per cápita	L_NC
Litro por día por cápita	L_NC
Litro por metro cuadrado	L_NC
Litro por metro cuadrado Fh dia	L_NC
Litro por metro cuadrado Fh minuto	L_NC
Litro por metro cuadrado Fh segundo	L_NC
Litro por metro cuadrado día	L_NC
Litro por metro cuadrado minuto	L_NC
Litro por metro cuadrado por dia	L_NC
Litro por metro cuadrado por minuto	L_NC
Litro por metro cuadrado por segundo	L_NC
Litro por metro cuadrado segundo	L_NC
Litro por metro cuadrado y día	L_NC
Litro por metro cuadrado y minuto	L_NC
Litro por metro cuadrado y segundo	L_NC
Litro por minuto	L_NC
Litro por segundo	L_NC
Lluvia torrencial	L_NC
Lo de menos	L_RG
Lo malo es que	L_CS
Lo uno por lo otro	L_RG
Local comercial	L_NC
Loco citato	L_RG
Lt Fh d per càpita	L_NCFS000
Lt Fh d por càpita	L_NCFS000
Lt Fh m2	L_NCFS000
Lt Fh m2 Fh d	L_NCFS000
Lt Fh m2 Fh min	L_NCFS000
Lt Fh m2 Fh s	L_NCFS000
Lucha armada	L_NCFS000
Lucha por el poder	L_NCFS000
Lucro cesante	L_NCMS000
Luego que	L_CS
Lugar de nacimiento	L_NC
Luz blanca	L_NC
Línea de acción	L_NC
Línea eléctrica	L_NC
Línea fija	L_NCFS000
M Fh s	L_NCFS000
M3 Fh h	L_NCFS000
M3 Fh ha Fh d	L_NCFS000
M3 Fh hora	L_NCFS000
M3 Fh m2 Fh d	L_NCFS000
M3 Fh m2 Fh h	L_NCFS000
M3 Fh s	L_NCFS000
M3 Fh seg	L_NCFS000
Madre naturaleza	L_NCFS000
Madre soltera	L_NC
Maguer que	L_CS
Mal a mal	L_RG
Manu militari	L_RG
Mapa topográfico	L_NC
Marco de referencia	L_NC
Marco general	L_NCMS000
Margen bruto	L_NCCS000
Matemática aplicada	L_NC
Material complementario	L_NC
Material de oficina	L_NCMS000
Material eléctrico	L_NCMS000
Material escrito	L_NCMS000
Material plástico	L_NCMS000
Matrimonio civil	L_NC
Mecánica cuántica	L_NCFS000
Mecánica de fluidos	L_NCFS000
Medalla de bronce	L_NC
Medalla de oro	L_NC
Medalla de plata	L_NC
Media jornada	L_NCFS000
Mediana empresa	L_NCFS000
Medicina de urgencias	L_NCFS000
Medicina general	L_NCFS000
Medicina interna	L_NCFS000
Medicina natural	L_NCFS000
Medicina nuclear	L_NCFS000
Medida de seguridad	L_NC
Medio ambiente	L_NCMS000
Medio de transporte	L_NC
Medio natural	L_NCMS000
Medio rural	L_NCMS000
Medio urbano	L_NCMS000
Medios de comunicación	L_NCMP000
Medios de comunicación de masas	L_NCMP000
Medios económicos	L_NCMP000
Memoria anual	L_NCFS000
Memoria ram	L_NCFS000
Memoria virtual	L_NCFS000
Mensaje de correo electrónico	L_NC
Mensaje de error	L_NC
Mensaje electrónico	L_NC
Mercado abierto	L_NCMS000
Mercado bursátil	L_NC
Mercado secundario	L_NCMS000
Merced a que	L_CS
Mesa de negociación	L_NC
Metro Fh s	L_NC
Metro Fh segundo	L_NC
Metro cuadrado	L_NC
Metro cúbico Fh hora	L_NC
Metro cúbico Fh segundo	L_NC
Metro cúbico por hora	L_NC
Metro cúbico por segundo	L_NC
Metro por segundo	L_NC
Metro segundo	L_NC
Mi Fh h	L_NCFS000
Miembro del consejo	L_NC
Miembro del partido	L_NC
Miembro titular	L_NC
Mientras que	L_CS
Milla Fh hora	L_NC
Milla cuadrado	L_NC
Milla por hora	L_NC
Milímetro cuadrado	L_NC
Milímetro cúbico	L_NC
Milímetro de hg	L_NC
Milímetro de mercurio	L_NC
Ministerio de asuntos exteriores	L_NCMS000
Ministerio de educación y ciencia	L_NCMS000
Ministerio de hacienda	L_NCMS000
Ministerio de justicia	L_NCMS000
Ministro de asuntos exteriores	L_NC
Ministro de hacienda	L_NC
Ministro de obras públicas	L_NC
Mirando a	L_SPS00
Mirando hacia	L_SPS00
Misión comercial	L_NCFS000
Ml Fh d	L_NCFS000
Mlt Fh d	L_NCFS000
Mobiliario urbano	L_NCFS000
Modelo conceptual	L_NC
Modelo de gestión	L_NC
Modelo económico	L_NC
Modelo matemático	L_NC
Modelo oficial	L_NC
Modelo teórico	L_NC
Modificación de datos	L_NC
Moneda nacional	L_NCFS000
Moneda única	L_NCFS000
Monóxido de carbono	L_NCFS000
Mortalidad infantil	L_NCFS000
Mortis causa	L_RG
Motor de búsqueda	L_NC
Motor eléctrico	L_NC
Motu proprio	L_AQ0CN0
Motu proprio	L_RG
Movilidad geográfica	L_NCFS000
Movimiento de resistencia	L_NCMS000
Movimiento internacional	L_NCMS000
Movimiento nacional	L_NCMS000
Movimiento obrero	L_NCMS000
Movimiento revolucionario	L_NCMS000
Muerte violenta	L_NC
Muestra representativa	L_NCFS000
Mundo material	L_NCMS000
Mutatis mutandis	L_RG
Muy de mañana	L_RG
Máquina virtual	L_NC
Más allá de	L_SPS00
Más de la cuenta	L_RG
Más valiera	L_RG
Médico general	L_NC
Médicos sin fronteras	L_NCMP000
Método científico	L_NC
Música de cámara	L_NCFS000
Música electrónica	L_NCFS000
Música moderna	L_NCFS000
Música popular	L_NCFS000
Música religiosa	L_NCFS000
N Fh m2	L_NCMP000
N Fh m2	L_NCMP000
Naciones unidas	L_NCFP000
Nada más y nada menos	L_RG
Naturaleza humana	L_NCFS000
Naturaleza jurídica	L_NCFS000
Navegación aérea	L_NCFS000
Navegación marítima	L_NCFS000
Necesidad básica	L_NC
Necesidades educativas especiales	L_NCFP000
Negociación colectiva	L_NCFS000
New look	L_AQ0CN0
Newton Fh metro cuadrado	L_NC
Newton por metro cuadrado	L_NC
Ni a la de tres	L_RG
Ni a tiros	L_RG
Ni aún	L_RG
Ni corto ni perezoso	L_RG
Ni fu ni fa	L_RG
Ni hablar del peluquín	L_RG
Ni mucho menos	L_RG
Ni más ni menos	L_RG
Ni que	L_CS
Ni que decir tiene	L_RG
Ni remotamente	L_RG
Ni rey ni roque	L_RG
Ni suena ni truena	L_RG
Ni tan sólo	L_RG
Ni tanto así	L_RG
Ni tanto ni tan calvo	L_RG
Ni tanto ni tan poco	L_RG
Nivel de calidad	L_NC
Nivel de confianza	L_NC
Nivel de empleo	L_NCMS000
Nivel de estudios	L_NCMS000
Nivel de exigencia	L_NCMS000
Nivel de precios	L_NCMS000
Nivel de seguridad	L_NC
Nivel de vida	L_NCMS000
Nivel educativo	L_NCMS000
Nivel técnico	L_NCMS000
No ha lugar	L_RG
No obstante	L_CC
No sea que	L_CS
Nombre comercial	L_NC
Nombre de usuario	L_NC
Nombre del archivo	L_NC
Norma básica	L_NC
Norma jurídica	L_NC
Normalización lingüística	L_NCFS000
Normas de aplicación	L_NCFP000
Normas de seguridad	L_NCFP000
Normas sociales	L_NCFP000
Normativa vigente	L_NCFS000
Nota media	L_NC
Nota simple	L_NCFS000
Nueva economía	L_NCFS000
Núcleo familiar	L_NC
Número de alumnos	L_NCMS000
Número de cuenta	L_NCMS000
Número de identificación	L_NCMS000
Número de identificación fiscal	L_NCMS000
Número de profesores	L_NCMS000
Números rojos	L_NCMP000
O sea	L_CC
Obispo auxiliar	L_NC
Obra de teatro	L_NC
Obra nueva	L_NCFS000
Obra social	L_NC
Obras de infraestructura	L_NCFP000
Observatorio astronómico	L_NC
Ocupación militar	L_NCFS000
Oferta educativa	L_NCFS000
Off line	L_RG
Oficina central	L_NCFS000
Oficina de empleo	L_NC
Oficina de información	L_NC
Oficina principal	L_NCFS000
Oficina técnica	L_NC
Ola de calor	L_NCFS000
Ola de frío	L_NCFS000
On line	L_RG
Oncología médica	L_NCFS000
Onza fluido	L_NC
Opción de compra	L_NC
Operación comercial	L_NC
Operación militar	L_NC
Operador o	L_NCFS000
Operador y	L_NCFS000
Orden constitucional	L_NCFS000
Orden de prioridad	L_NCFS000
Orden establecido	L_NCFS000
Orden jurisdiccional	L_NCFS000
Orden jurídico	L_NCFS000
Orden ministerial	L_NCFS000
Ordenación general del sistema educativo	L_NCFS000
Ordenación urbana	L_NCFS000
Ordenamiento jurídico	L_NCMS000
Ordenanza fiscal	L_NC
Ordenanza municipal	L_NC
Organismo oficial	L_NC
Organización de empresas	L_NC
Organización de las naciones unidas	L_NCFS000
Organización de las naciones unidas para la agricultura y la alimentación	L_NCFS000
Organización de las naciones unidas para la educación, la ciencia y la cultura	L_NCFS000
Organización de los estados americanos	L_NCFS000
Organización sin fines de lucro	L_NC
Organización social	L_NC
Orientación educativa	L_NCFS000
Oso hormiguero	L_NC
Pacto social	L_NCMS000
Padrón municipal	L_NCMS000
Pago anticipado	L_NCMS000
Pago en efectivo	L_NCMS000
Paisaje natural	L_NCMS000
Paisaje urbano	L_NCMS000
Palacio de justicia	L_NCMS000
Palacio de los deportes	L_NCMS000
Pantalla de cristal liquido	L_NC
Pantalla de cristal líquido	L_NC
Papel continuo	L_NCMS000
Para colmo	L_RG
Para dar y tomar	L_RG
Para más inri	L_RG
Para que	L_CS
Para rato	L_RG
Para remate	L_RG
Para todo trote	L_RG
Parecido a	L_SPS00
Parlamento europeo	L_NCMS000
Parlamento vasco	L_NCMS000
Parque de bomberos	L_NC
Parque eólico	L_NC
Parte contratante	L_NC
Partida de nacimiento	L_NC
Partido amistoso	L_NC
Partido comunista	L_NCMS000
Partido conservador	L_NCMS000
Partido de ida	L_NC
Partido de vuelta	L_NC
Partido liberal	L_NCMS000
Partido oficial	L_NCMS000
Partido político	L_NC
Partido socialista obrero español	L_NCMS000
Parálisis cerebral	L_NC
Pasado mañana	L_RG
Pasión de cristo	L_NCFS000
Patata frita	L_NC
Patrimonio artístico	L_NC
Patrimonio cultural	L_NC
Patrimonio histórico-artístico	L_NC
País en desarrollo	L_NC
Peccata minuta	L_AQ0CN0
Pensamiento filosófico	L_NCMS000
Pensión de jubilación	L_NC
Pequeña empresa	L_NC
Pequeñas y medianas empresas	L_NCFP000
Per cápita	L_AQ0CN0
Permiso de conducir	L_NC
Permiso de residencia	L_NC
Persona de edad avanzada	L_NC
Personal administrativo	L_NCMS000
Personal docente	L_NCMS000
Personalidad jurídica	L_NCFS000
Personalidad jurídica propia	L_NCFS000
Perspectiva histórica	L_NCFS000
Perspectivas económicas	L_NCFP000
Período de vacaciones	L_NC
Período de validez	L_NCMS000
Período de vigencia	L_NCMS000
Pescado fresco	L_NCMS000
Pese a	L_SPS00
Pese a que	L_CS
Pie Fh hora	L_NC
Pie Fh minuto	L_NC
Pie Fh segundo	L_NC
Pie Fh segundo Fh segundo	L_NC
Pie Fh segundo por segundo	L_NC
Pie Fh segundo segundo	L_NC
Pie cuadrado	L_NC
Pie cúbico	L_NC
Pie cúbico Fh minuto	L_NC
Pie cúbico Fh segundo	L_NC
Pie cúbico por minuto	L_NC
Pie cúbico por segundo	L_NC
Pie de agua	L_NC
Pie hora	L_NC
Pie minuto	L_NC
Pie por hora	L_NC
Pie por minuto	L_NC
Pie por segundo	L_NC
Pie por segundo Fh segundo	L_NC
Pie por segundo al cuadrado	L_NC
Pie por segundo cuadrado	L_NC
Pie por segundo por segundo	L_NC
Pie por segundo segundo	L_NC
Pie segundo	L_NC
Pie segundo Fh segundo	L_NC
Pie segundo por segundo	L_NC
Pie segundo segundo	L_NC
Piscina cubierta	L_NC
Plan de emergencia	L_NC
Plan de gestión	L_NC
Plan general de contabilidad	L_NCMS000
Planificación económica	L_NCFS000
Planificación familiar	L_NCFS000
Plano de situación	L_NCMS000
Plazo de admisión	L_NC
Pleno del ayuntamiento	L_NC
Pleno empleo	L_NCMS000
Pleno municipal	L_NC
Población objetivo	L_NCFS000
Poco a poco	L_RG
Policía judicial	L_NCCS000
Polígono industrial	L_NC
Política ambiental	L_NC
Política de defensa	L_NC
Política de empleo	L_NC
Política económica	L_NC
Por adarmes	L_RG
Por al lado de	L_SPS00
Por amor de Dios	L_RG
Por anticipado	L_RG
Por aquel entonces	L_RG
Por arte de birlibirloque	L_RG
Por arte de magia	L_RG
Por barba	L_RG
Por carambola	L_RG
Por causa de	L_SPS00
Por ce o por be	L_RG
Por ceremonia	L_RG
Por concuerda	L_RG
Por consecuencia	L_RG
Por consiguiente	L_RG
Por contera	L_RG
Por cuatro reales	L_RG
Por cuenta de	L_SPS00
Por cuenta y riesgo	L_RG
Por de contado	L_RG
Por de pronto	L_RG
Por debajo de	L_SPS00
Por debajo de cuerda	L_RG
Por decirlo así	L_RG
Por delante de	L_SPS00
Por dentro de	L_SPS00
Por descontado	L_RG
Por detrás de	L_SPS00
Por duplicado	L_RG
Por ejemplo	L_RG
Por el centro de	L_SPS00
Por el contrario	L_RG
Por el otro lado de	L_SPS00
Por en medio	L_RG
Por ende	L_RG
Por ensalmo	L_RG
Por entonces	L_RG
Por esos mundos de Dios	L_RG
Por este lado de	L_SPS00
Por favor	L_RG
Por hache o por be	L_RG
Por igual	L_RG
Por intuito	L_RG
Por la cuenta que	L_CS
Por la gracia de Dios	L_RG
Por lo bajines	L_RG
Por lo bajini	L_RG
Por lo bajinis	L_RG
Por lo claro	L_RG
Por lo común	L_RG
Por lo general	L_RG
Por lo menos	L_RG
Por lo presente	L_RG
Por lo pronto	L_RG
Por lo tanto	L_RG
Por medio de	L_SPS00
Por minutos	L_RG
Por motivo de	L_SPS00
Por mucho que	L_CS
Por más que digas	L_RG
Por nada del mundo	L_RG
Por ningún concepto	L_RG
Por norma general	L_RG
Por obra de	L_SPS00
Por obra y gracia de	L_SPS00
Por onzas	L_RG
Por otro lado	L_RG
Por oídas	L_RG
Por pura fórmula	L_RG
Por razón de que	L_CS
Por real decreto	L_RG
Por regla general	L_RG
Por segundo año consecutivo	L_RG
Por separado	L_RG
Por si acaso	L_RG
Por si las moscas	L_RG
Por siempre jamás	L_RG
Por supuesto	L_RG
Por testa	L_RG
Por todo lo alto	L_RG
Por un tris	L_RG
Por ventura	L_RG
Por virtud de	L_SPS00
Potencia de salida	L_NCFS000
Potestad sancionadora	L_NCFS000
Precio de mercado	L_NCMS000
Precio máximo	L_NCMS000
Precio mínimo	L_NCMS000
Precio unitario	L_NCMS000
Precio único	L_NCMS000
Predicción del tiempo	L_NC
Predicción meteorológica	L_NC
Preparador físico	L_NC
Presidencia del gobierno	L_NCFS000
Presidente del consejo de administración	L_NC
Presidente del parlamento	L_NCMS000
Presión sanguínea	L_NCFS000
Presupuesto aprobado	L_NC
Presupuesto nacional	L_NC
Prevención de riesgos	L_NCFS000
Prevención de riesgos laborales	L_NCFS000
Primer ministro	L_NC
Primera comunión	L_NCFS000
Primera guerra mundial	L_NCFS000
Primero de mayo	L_NCMS000
Primeros auxilios	L_NCMP000
Principio de igualdad	L_NCMS000
Principio de legalidad	L_NCMS000
Principios generales del derecho	L_NCMP000
Procedimiento administrativo	L_NC
Procedimiento de evaluación	L_NC
Procedimiento judicial	L_NC
Procesamiento de la información	L_NCMP000
Proceso administrativo	L_NC
Proceso de datos	L_NCMS000
Proceso de desarrollo	L_NCMS000
Proceso de fabricación	L_NCMS000
Proceso de integración	L_NCMS000
Proceso de socialización	L_NCMS000
Proceso educativo	L_NCMS000
Producción agrícola	L_NC
Producción cinematográfica	L_NC
Producción editorial	L_NC
Producción editorial	L_NCFS000
Producto bruto	L_NCMS000
Producto nacional	L_NC
Producto químico	L_NC
Profesor emérito	L_NC
Profesor titular	L_NC
Programa de las naciones unidas para el medio ambiente	L_NCMS000
Programa gratuito	L_NC
Programación general	L_NCMS000
Progreso económico	L_NCMS000
Promoción del empleo	L_NCFS000
Promulgación de la ley	L_NCFS000
Propiedad urbana	L_NCFS000
Proposición de ley	L_NCFS000
Proposición no de ley	L_NCFS000
Prosperidad económica	L_NCFS000
Protocolo de kioto	L_NCMS000
Protocolo tcp-ip	L_NCFS000
Protocolo tcp/ip	L_NCFS000
Proyecto de ley	L_NC
Proyecto empresarial	L_NC
Prueba documental	L_NC
Práctica clínica	L_NC
Préstamo hipotecario	L_NC
Psicología aplicada	L_NCFS000
Psicología clínica	L_NCFS000
Psicología cognitiva	L_NCFS000
Psicología evolutiva	L_NCFS000
Psicología general	L_NCFS000
Psicología social	L_NCFS000
Publicidad comercial	L_NCFS000
Pues bien	L_RG
Pues sí que	L_CS
Pues sí que	L_I
Puesta en servicio	L_NCFS000
Pulgada Fh segundo Fh segundo	L_NC
Pulgada Fh segundo por segundo	L_NC
Pulgada Fh segundo segundo	L_NC
Pulgada agua	L_NC
Pulgada cuadrado	L_NC
Pulgada cúbico	L_NC
Pulgada de agua	L_NC
Pulgada de hg	L_NC
Pulgada hg	L_NC
Pulgada por segundo Fh segundo	L_NC
Pulgada por segundo al cuadrado	L_NC
Pulgada por segundo cuadrado	L_NC
Pulgada por segundo por segundo	L_NC
Pulgada por segundo segundo	L_NC
Pulgada segundo Fh segundo	L_NC
Pulgada segundo por segundo	L_NC
Pulgada segundo segundo	L_NC
Punto crítico	L_NC
Punto de cruz	L_NCMS000
Punto de equilibrio	L_NCMS000
Punto de partida	L_NCMS000
Punto de referencia	L_NCMS000
Punto focal	L_NCMS000
Puntuación media	L_NCMS000
Página personal	L_NC
Página web	L_NC
Página web personal	L_NC
Que ni hecho de encargo	L_RG
Que ni pintado	L_RG
Que pela	L_RG
Que si tal que si cual	L_RG
Queso fresco	L_NC
Quiera que no	L_RG
Quieras que no	L_RG
Química ambiental	L_NCFS000
Química general	L_NCMS000
Química industrial	L_NCMS000
Rad Fh s	L_NCFS000
Radiación solar	L_NC
Radiación ultravioleta	L_NC
Radián Fh segundo	L_NC
Radián por segundo	L_NC
Ramo de flores	L_NC
Rara vez	L_RG
Rayos x	L_NCMP000
Reacción química	L_NC
Real decreto ley	L_NCMS000
Recaudación de impuestos	L_NCMS000
Reconocimiento de voz	L_NCMS000
Recurso administrativo	L_NC
Recursos hídricos	L_NCMP000
Recursos públicos	L_NCMP000
Red de datos	L_NCFS000
Red de relaciones	L_NCFS000
Red ethernet	L_NCFS000
Red informática	L_NCFS000
Red privada	L_NCFS000
Red pública	L_NCFS000
Red telefónica	L_NCFS000
Reducción de jornada	L_NCFS000
Reducción de la jornada	L_NCFS000
Reforma constitucional	L_NC
Reforma tributaria	L_NC
Registro de datos	L_NC
Regla de oro	L_NC
Regresión lineal	L_NCFS000
Reino animal	L_NCMS000
Reinserción social	L_NCMS000
Relaciones de producción	L_NCFP000
Relaciones diplomáticas	L_NCFP000
Relaciones humanas	L_NCFP000
Relación bilateral	L_NCFS000
Relación de dependencia	L_NCFS000
Relación jurídica	L_NCFS000
Relación personal	L_NC
Relata réfero	L_RG
Rendimiento escolar	L_NCMS000
Renta variable	L_NC
Rentabilidad económica	L_NC
Representación diplomática	L_NC
Representación gráfica	L_NC
Representación legal	L_NC
Representación proporcional	L_NCFS000
Representante del gobierno	L_NC
Reproducción asistida	L_NCFS000
Reproductor de dvd	L_NC
República federal	L_NCFS000
Reserva de la biosfera	L_NC
Reserva legal	L_NCFS000
Residencia habitual	L_NCFS000
Residencia oficial	L_NC
Resistencia de materiales	L_NCFS000
Resolución administrativa	L_NC
Resolución impugnada	L_NC
Respecto a	L_SPS00
Respecto a que	L_CS
Respecto de	L_SPS00
Responsabilidad administrativa	L_NC
Responsabilidad civil	L_NC
Resultado oficial	L_NC
Retraso mental	L_NCMS000
Revolución cultural	L_NCFS000
Revolución francesa	L_NCFS000
Revolución socialista	L_NCFS000
Riesgo social	L_NC
Rigor científico	L_NCMS000
Ritmo cardiaco	L_NCMS000
Ritmo de trabajo	L_NCMS000
Rock and roll	L_NCMS000
Role playing	L_NCMS000
Roll on	L_AQ0CN0
Régimen capitalista	L_NCMS000
Régimen democrático	L_NCMS000
Régimen disciplinario	L_NCMS000
Régimen económico	L_NCMS000
Régimen general de la seguridad social	L_NCMS000
Régimen jurídico	L_NCMS000
Régimen político	L_NCMS000
Régimen tributario	L_NCMS000
Río abajo	L_RG
Río arriba	L_RG
Sagrada familia	L_NCMS000
Sala de prensa	L_NC
Salario base	L_NC
Salario mínimo	L_NC
Salga lo que salga	L_RG
Salsa de tomate	L_NC
Salud ambiental	L_NCFS000
Salud bucodental	L_NCFS000
Salón de plenos	L_NC
Santa misa	L_NCFS000
Santo oficio	L_NCMS000
Santo sepulcro	L_NCMS000
Santísima trinidad	L_NCMS000
Santísimo sacramento	L_NCMS000
Sea cual fuere	L_RG
Sea lo que fuere	L_RG
Secretaría de estado	L_NCFS000
Secretaría de gobierno	L_NCFS000
Secretaría general	L_NCFS000
Sector agrario	L_NCMS000
Sector agrícola	L_NCMS000
Sector económico	L_NCMS000
Sector turístico	L_NCMS000
Segunda guerra mundial	L_NCFS000
Segunda lengua	L_NC
Seguridad del estado	L_NCFS000
Seguridad e higiene	L_NCFS000
Seguridad internacional	L_NCFS000
Seguridad jurídica	L_NCFS000
Seguridad personal	L_NCFS000
Seguro de accidentes	L_NC
Seguro de vida	L_NC
Seguro obligatorio	L_NC
Seguro social	L_NC
Según como	L_RG
Según el decir de	L_SPS00
Según que	L_CS
Selección nacional	L_NC
Selección natural	L_NCFS000
Selva tropical	L_NC
Semejante a	L_SPS00
Sensu lato	L_RG
Sensu stricto	L_RG
Sentencia firme	L_NCFS000
Sentido contrario	L_NCMS000
Sentido crítico	L_NCMS000
Sentido de responsabilidad	L_NCMS000
Sentido del humor	L_NCMS000
Sentido literal	L_NCMS000
Sentimiento de culpa	L_NC
Separación de poderes	L_NCFS000
Servicio asistencial	L_NC
Servicio de apoyo	L_NC
Servicio de atención al cliente	L_NC
Servicio de información	L_NC
Servicio de urgencias	L_NC
Servicio educativo	L_NC
Servicio jurídico	L_NC
Servicio meteorológico	L_NC
Servicio público	L_NC
Servicio turístico	L_NC
Servicios funerarios	L_NCMP000
Servicios sociales	L_NCMP000
Servicios urbanos	L_NCMP000
Servidor dns	L_NC
Servidor proxy	L_NC
Servidor web	L_NC
Sesión continua	L_NC
Sesión plenaria	L_NC
Si acaso	L_RG
Si bien se mira	L_RG
Si no es por	L_SPS00
Si no es que	L_CC
Siempre y cuando	L_RG
Siendo así	L_RG
Silencio administrativo	L_NCMS000
Similar a	L_SPS00
Sin ambages	L_RG
Sin chistar ni mistar	L_RG
Sin comerlo ni beberlo	L_RG
Sin contar con	L_SPS00
Sin contar con que	L_CS
Sin duda alguna	L_RG
Sin ir más lejos	L_RG
Sin lugar a dudas	L_RG
Sin más ni más	L_RG
Sin necesidad de	L_SPS00
Sin ninguna duda	L_RG
Sin pena ni gloria	L_RG
Sin perjuicio de	L_SPS00
Sin qué ni para qué	L_RG
Sin ton ni son	L_RG
Sin trastes	L_RG
Sin venir a pelo	L_RG
Sino que	L_CC
Sistema abierto	L_NCMS000
Sistema de clasificación	L_NC
Sistema de comunicación	L_NC
Sistema de correo	L_NC
Sistema de defensa	L_NC
Sistema de ficheros	L_NC
Sistema de gestión	L_NC
Sistema de gobierno	L_NC
Sistema de información geográfica	L_NC
Sistema de juego	L_NC
Sistema de medición	L_NC
Sistema de partidos	L_NC
Sistema de producción	L_NC
Sistema de seguridad	L_NC
Sistema democrático	L_NC
Sistema económico	L_NC
Sistema educativo	L_NC
Sistema electoral	L_NC
Sistema electrónico	L_NC
Sistema federal	L_NC
Sistema fiscal	L_NC
Sistema informático	L_NC
Sistema métrico	L_NCMS000
Sistema nacional de salud	L_NCMS000
Sistema nervioso	L_NCMS000
Sistema nervioso central	L_NCMS000
Sistema social	L_NCMS000
Sistema tributario	L_NCMS000
Sitio web	L_NC
Situación administrativa	L_NCFS000
Situación de emergencia	L_NC
Situación económica	L_NCFS000
Situación financiera	L_NCFS000
Situación jurídica	L_NCFS000
So pena de que	L_CS
So pena que	L_CS
Soberanía nacional	L_NCFS000
Soberanía popular	L_NCFS000
Sobre manera	L_RG
Sobre seguro	L_RG
Sociedad capitalista	L_NC
Sociedad financiera	L_NC
Socio fundador	L_NC
Sociología política	L_NCFS000
Software educativo	L_NC
Solidaridad internacional	L_NCFS000
Soporte físico	L_NC
Sub voce	L_RG
Subsecretario de estado	L_NC
Suelo no urbanizable	L_NCMS000
Suelo urbanizable	L_NCMS000
Suministro de energía eléctrica	L_NC
Superficie plana	L_NC
Superficie útil	L_NCFS000
Supuesto que	L_CS
Sustancia química	L_NC
Sábado santo	L_NCMS000
Síndrome de down	L_NCMS000
Súper 8	L_NCFS000
Tal cual	L_RG
Tal vez	L_RG
Tal y como	L_CS
Taller mecánico	L_NC
Tamaño de la población	L_NCMS000
Tamaño natural	L_NCMS000
Tan pronto como	L_CS
Tan siquiera	L_RG
Tanto menos que	L_CS
Tanto más que	L_CS
Tanto peor	L_RG
Tanto por ciento	L_RG
Tanto por tanto	L_RG
Tarjeta de identificación	L_NC
Tarjeta de red	L_NC
Tarjeta de sonido	L_NC
Tarjeta de vídeo	L_NC
Tarjeta gráfica	L_NC
Tarjeta pcmcia	L_NC
Tarjeta roja	L_NC
Tasa de cambio	L_NC
Tasa de crecimiento	L_NC
Tasa de desempleo	L_NC
Tasa de inflación	L_NC
Tasa de paro	L_NC
Taza de café	L_NC
Tecnología avanzada	L_NCFS000
Tecnología educativa	L_NCFS000
Tejido adiposo	L_NCMS000
Tejido conectivo	L_NCMS000
Telefonía ip	L_NCMS000
Televisión educativa	L_NCFS000
Tema de investigación	L_NC
Temperatura del agua	L_NCFS000
Temperatura extrema	L_NC
Tensión arterial	L_NCFS000
Teoría crítica	L_NCFS000
Teoría de la comunicación	L_NCFS000
Teoría de la relatividad	L_NCFS000
Teoría económica	L_NC
Teoría política	L_NC
Terapia física	L_NCFS000
Terapia ocupacional	L_NCFS000
Tercera división	L_NCFS000
Tercera edad	L_NCFS000
Terreno de juego	L_NC
Territorio nacional	L_NCMS000
Tesis doctoral	L_NC
Testigo de jehová	L_NC
Texto legal	L_NC
Texto original	L_NC
Tiempo de exposición	L_NCMS000
Tiempo de servicio	L_NCMS000
Tienda especializada	L_NC
Tierra adentro	L_RG
Tipo de cambio	L_NC
Tipo de datos	L_NC
Tipo de trabajo	L_NC
Tipo de vegetación	L_NC
Tira cómica	L_NC
Tiro libre	L_NCMS000
Titulación académica	L_NC
Todo lo contrario	L_I
Todo lo contrario	L_RG
Toma de decisiones	L_NCFS000
Tonelada métrico	L_NC
Tono de voz	L_NC
Tono muscular	L_NCMS000
Trabajo asalariado	L_NCMS000
Trabajo de campo	L_NC
Trabajo doméstico	L_NC
Trabajo en grupo	L_NC
Trabajo grupal	L_NCMS000
Trabajo nocturno	L_NC
Trabajos forzados	L_NCMP000
Tracto gastrointestinal	L_NCMS000
Traducción automática	L_NCFS000
Transacción comercial	L_NC
Transferencia de datos	L_NC
Transferencia de información	L_NCFS000
Transmisión de datos	L_NC
Transporte aéreo	L_NC
Transporte de viajeros	L_NCMS000
Transporte público	L_NCMS000
Tratado de la unión europea	L_NCMS000
Tratado de paz	L_NC
Tratamiento de aguas residuales	L_NCMS000
Tratamiento de datos	L_NCMS000
Tratamiento de imágenes	L_NCMS000
Tratamiento térmico	L_NCMS000
Tribunal de apelación	L_NC
Tribunal superior de justicia	L_NCMS000
Tráfico de drogas	L_NCMS000
Tumor cerebral	L_NC
Turismo activo	L_NCMS000
Tutti quanti	L_RG
Té verde	L_NCMS000
Técnica de evaluación	L_NC
Técnica mixta	L_NC
Técnico auxiliar	L_NC
Técnico económico	L_NC
Título académico	L_NC
Título de bachiller	L_NC
Título de propiedad	L_NC
Título oneroso	L_NCMS000
Título preliminar	L_NCMS000
Título profesional	L_NC
Título superior	L_NCMS000
Un día u otro	L_RG
Un día y otro	L_RG
Un poco tarde	L_RG
Una vez que	L_CS
Una y no más	L_RG
Unidad administrativa	L_NC
Unidad de control	L_NC
Unidad de cuidados intensivos	L_NCFS000
Unidad de gestión	L_NC
Unidad de información	L_NC
Unidad de masa atómica	L_NC
Unidad de medida	L_NC
Unidad de producción	L_NC
Unidad de tiempo	L_NC
Unidad didáctica	L_NC
Unidad familiar	L_NCFS000
Universidad del país vasco	L_NCFS000
Universidad nacional de educación a distancia	L_NCFS000
Unión aduanera	L_NCFS000
Unión económica	L_NCFS000
Unión económica y monetaria	L_NCFS000
Unión europea	L_NCFS000
Unión general de trabajadores	L_NCFS000
Uno por uno	L_RG
Urbi et orbi	L_AQ0CN0
Urbi et orbi	L_RG
Uso privado	L_NCMS000
Uso residencial	L_NCMS000
Usuario registrado	L_NC
Utilidad pública	L_NCFS000
V Fh m	L_NCFS000
Valor absoluto	L_NC
Valor artístico	L_NCMS000
Valor de mercado	L_NC
Valor económico	L_NCMS000
Valor estimado	L_NCMS000
Valor inicial	L_NC
Valor medio	L_NCMS000
Valor nominal	L_NCMS000
Valor numérico	L_NCMS000
Valor probatorio	L_NCMS000
Valor social	L_NCMS000
Valores mobiliarios	L_NCMP000
Vapor de agua	L_NCMS000
Varita mágica	L_NC
Vaso de vino	L_NC
Vaya por dios	L_I
Velis nolis	L_RG
Velocidad de la luz	L_NCFS000
Velocidad de transferencia	L_NCFS000
Velocidad de transmisión	L_NCFS000
Velocidad del viento	L_NCFS000
Velocidad máxima	L_NCFS000
Venta de acciones	L_NC
Venta directa	L_NC
Viabilidad económica	L_NCFS000
Viaje de ida	L_NC
Vicario general	L_NC
Vida en sociedad	L_NCFS000
Vida profesional	L_NCFS000
Villa olímpica	L_NCFS000
Violencia doméstica	L_NCFS000
Violencia familiar	L_NCFS000
Virus de la inmunodeficiencia humana	L_NCMN000
Vitamina a	L_NCFS000
Vitamina c	L_NCFS000
Vitamina d	L_NCFS000
Vitamina e	L_NCFS000
Vivienda habitual	L_NCFS000
Vivienda social	L_NCFS000
Volt Fh metro	L_NC
Volt por metro	L_NC
Volumen de negocios	L_NCMS000
Volumen de trabajo	L_NCMS000
Voluntariado social	L_NCMS000
Voto a bríos	L_RG
Voto particular	L_NCMS000
Vox populi	L_RG
Vía férrea	L_NC
Vía respiratoria	L_NC
Vídeo vhs	L_NCMS000
W Fh m K	L_NCFS000
W Fh srad	L_NCFS000
Watt Fh estereoradián	L_NC
Watt Fh metro Fh grado kelvin	L_NC
Watt Fh metro Fh kelvin	L_NC
Watt Fh metro por grado kelvin	L_NC
Watt Fh metro por kelvin	L_NC
Watt por estereoradián	L_NC
Watt por metro Fh grado kelvin	L_NC
Watt por metro Fh kelvin	L_NC
Watt por metro por grado kelvin	L_NC
Watt por metro por kelvin	L_NC
Ya es mucho decir	L_RG
Ya que	L_CS
Ya será menos	L_RG
Yarda cuadrado	L_NC
Yarda cúbico	L_NC
Zona arqueológica	L_NC
Zona comercial	L_NC
Zona de descanso	L_NC
Zona de libre comercio	L_NCFS000
Zona de trabajo	L_NC
Zona franca	L_NCFS000
Zona horaria	L_NCFS000
Zona privada	L_NC
Zona residencial	L_NC
Zona restringida	L_NC
Zona turística	L_NC
a anequín	L_RG
a barlovento	L_RG
a barrisco	L_RG
a base de	L_SPS00
a base de bien	L_RG
a boca de cañón	L_RG
a bocajarro	L_RG
a bombo y platillo	L_RG
a borbollones	L_RG
a borbotones	L_RG
a bordo	L_RG
a bote pronto	L_RG
a brazo partido	L_RG
a bruces	L_RG
a buen recaudo	L_RG
a buen seguro	L_RG
a buen tino	L_RG
a buena cuenta	L_RG
a buena fe	L_RG
a buena luz	L_RG
a buena vista	L_RG
a buenas horas	L_RG
a buenas noches	L_RG
a bulto	L_RG
a cada instante	L_RG
a cada momento	L_RG
a cada paso	L_RG
a cada rato	L_RG
a cada trique	L_RG
a cada triquitraque	L_RG
a caja y espiga	L_RG
a cal y canto	L_RG
a caliche	L_RG
a cambio	L_RG
a cambio de	L_SPS00
a campo raso	L_RG
a campo traviesa	L_RG
a cara de perro	L_RG
a cara descubierta	L_RG
a carcajada limpia	L_RG
a cargo de	L_SPS00
a carretadas	L_RG
a carta cabal	L_RG
a casquete quitado	L_RG
a causa de	L_SPS00
a causa de que	L_CS
a centenares	L_RG
a cepillo	L_RG
a cerca de	L_SPS00
a cercen	L_RG
a cercén	L_RG
a chorros	L_RG
a cielo descubierto	L_RG
a ciencia cierta	L_RG
a codazo limpio	L_RG
a comisión	L_RG
a como de lugar	L_RG
a condición de	L_SPS00
a condición de que	L_CS
a consecuencia de	L_SPS00
a continuación de	L_SPS00
a contra reloj	L_RG
a contrahílo	L_RG
a contralecho	L_RG
a contramano	L_RG
a contrapelo	L_RG
a contrapié	L_RG
a corazón abierto	L_RG
a cordel	L_RG
a coro	L_RG
a costillas	L_RG
a coxcojilla	L_RG
a cruz y escuadra	L_RG
a cuatro patas	L_RG
a cuatro pies	L_RG
a cubos	L_RG
a cuenta de	L_SPS00
a cuerpo de rey	L_RG
a cuerpo descubierto	L_RG
a cuál más	L_RG
a cántaros	L_RG
a dentelladas	L_RG
a dentro	L_RG
a desmano	L_RG
a despecho	L_RG
a despecho de	L_SPS00
a destajo	L_RG
a destiempo	L_RG
a diario	L_RG
a dicho efecto	L_RG
a diferencia de	L_SPS00
a disgusto	L_RG
a distinción de	L_SPS00
a donde	L_RG
a dos dedos de	L_SPS00
a dos haces	L_RG
a dos manos	L_RG
a duras penas	L_RG
a dúo	L_RG
a efecto de que	L_CS
a efectos de	L_SPS00
a empellones	L_RG
a escape	L_RG
a escondidas	L_RG
a escondidillas	L_RG
a escote	L_RG
a escuadra	L_RG
a escusa	L_RG
a escusas	L_RG
a eso de	L_SPS00
a espaldas de	L_SPS00
a espeta perro	L_RG
a espinapez	L_RG
a espuertas	L_RG
a este lado de	L_SPS00
a excepción de	L_SPS00
a expensas	L_RG
a expensas de	L_SPS00
a fanegadas	L_RG
a favor de	L_SPS00
a fin de	L_SPS00
a fin de cuentas	L_RG
a fin de que	L_CS
a fines de	L_SPS00
a flor de agua	L_RG
a flor de piel	L_RG
a flote	L_RG
a fortiori	L_RG
a fuego lento	L_RG
a fuerza de	L_SPS00
a fuerza de que	L_CS
a gachas	L_RG
a gatas	L_RG
a gogó	L_RG
a grandes rasgos	L_RG
a granel	L_RG
a graves penas	L_RG
a guisa de	L_SPS00
a hito	L_RG
a horcajadas	L_RG
a hurtadillas	L_RG
a jarros	L_RG
a jornal	L_RG
a junta continua	L_RG
a juzgar como	L_RG
a juzgar por	L_SPS00
a la bartola	L_RG
a la buena ventura	L_RG
a la busca de	L_SPS00
a la chita callando	L_RG
a la cola	L_RG
a la espera de	L_SPS00
a la funerala	L_RG
a la inversa	L_RG
a la manera de	L_SPS00
a la mano de Dios	L_RG
a la mitad de	L_SPS00
a la morisma	L_RG
a la mujeriega	L_RG
a la papillote	L_RG
a la parrilla	L_RG
a la pata coja	L_RG
a la pata llana	L_RG
a la paz de Dios	L_RG
a la pendura	L_RG
a la perfección	L_RG
a la primera de cambio	L_RG
a la ronza	L_RG
a la siga de	L_SPS00
a la sirga	L_RG
a la sopa boba	L_RG
a la tentaruja	L_RG
a la tirolesa	L_RG
a la usanza de	L_SPS00
a la vez	L_RG
a la vez que	L_CS
a la vuelta de	L_SPS00
a la zona de	L_SPS00
a largas marchas	L_RG
a las calladas	L_RG
a las mil maravillas	L_RG
a las primeras de cambio	L_RG
a las puertas de la muerte	L_RG
a las veces	L_RG
a lata por canal	L_RG
a legua	L_RG
a leguas	L_RG
a libre plática	L_RG
a lo ancho de	L_SPS00
a lo bestia	L_RG
a lo discreto	L_RG
a lo garçon	L_RG
a lo grande	L_RG
a lo largo y a lo ancho	L_RG
a lo largo y ancho de	L_SPS00
a lo lejos	L_RG
a lo loco	L_RG
a lo moderno	L_RG
a lo más	L_RG
a lo que parece	L_RG
a lo que salga	L_RG
a lo sumo	L_RG
a lo tonto	L_RG
a lomo	L_RG
a lomos	L_RG
a los cuatro vientos	L_RG
a los piques	L_RG
a lumbre de pajas	L_RG
a lumbre mansa	L_RG
a lápiz	L_RG
a línea tirada	L_RG
a machamartillo	L_RG
a machote	L_RG
a mal dar	L_RG
a malas penas	L_RG
a manadas	L_RG
a manera de	L_SPS00
a mano airada	L_RG
a mano armada	L_RG
a manos llenas	L_RG
a mansalva	L_RG
a mares	L_RG
a mata caballo	L_RG
a matacaballo	L_RG
a mayor abundamiento	L_RG
a mazo y escoplo	L_RG
a media ladera	L_RG
a media madera	L_RG
a media margen	L_RG
a media rienda	L_RG
a media rodilla	L_RG
a media voz	L_RG
a mediados de	L_SPS00
a medias palabras	L_RG
a medida que	L_CS
a medio hacer	L_RG
a medio plazo	L_RG
a mediodía	L_RG
a medios pelos	L_RG
a menos que	L_CS
a mesa puesta	L_RG
a millaradas	L_RG
a mis anchas	L_RG
a mitad de	L_SPS00
a modo de	L_SPS00
a montón	L_RG
a mucha honra	L_RG
a muerte	L_AQ0CN0
a muerte	L_RG
a muerte o vida	L_RG
a mujeriega	L_RG
a más andar	L_RG
a más correr	L_RG
a más ganar	L_RG
a más mejor	L_RG
a más no poder	L_RG
a más tardar	L_RG
a más ver	L_RG
a más y mejor	L_RG
a nado	L_RG
a no ser que	L_CS
a nombre de	L_SPS00
a ojo de buen cubero	L_RG
a ojos vistas	L_RG
a pan y cuchillo	L_RG
a partir de	L_SPS00
a pasatoro	L_RG
a paseo	L_RG
a paso de tortuga	L_RG
a paso largo	L_RG
a pasto	L_RG
a pesar de	L_SPS00
a pesar de que	L_CS
a pesar de todo	L_RG
a peso de oro	L_RG
a petición de	L_SPS00
a peón	L_RG
a pica suelta	L_RG
a pico	L_RG
a pico de jarro	L_RG
a pie firme	L_RG
a pie llano	L_RG
a pierna suelta	L_RG
a pipiricojo	L_RG
a pique de maceta	L_RG
a plazo fijo	L_RG
a plazos	L_RG
a plomo	L_RG
a poco que	L_CS
a poco rato	L_RG
a pocos pasos	L_RG
a porfía	L_RG
a porrillo	L_RG
a pospelo	L_RG
a posteriori	L_RG
a pote	L_RG
a precio de coste	L_RG
a primera sangre	L_AQ0CN0
a principios de	L_SPS00
a priori	L_RG
a prisa	L_RG
a propósito de	L_SPS00
a prorrata	L_RG
a prueba de	L_SPS00
a puchos	L_RG
a puerta cerrada	L_RG
a puestas	L_RG
a punta de lanza	L_RG
a punta de pistola	L_RG
a punta pala	L_RG
a puntapiés	L_RG
a punto de	L_SPS00
a punto de caramelo	L_RG
a punto de que	L_CS
a punto de solfa	L_RG
a punto fijo	L_RG
a punto largo	L_RG
a pupilo	L_RG
a puñados	L_RG
a puño cerrado	L_RG
a quema ropa	L_RG
a quemarropa	L_RG
a rachas	L_RG
a raja tabla	L_RG
a rajatabla	L_RG
a ras de	L_SPS00
a ras de tierra	L_RG
a ras del suelo	L_RG
a rastras	L_RG
a ratos perdidos	L_RG
a raudales	L_RG
a razón de	L_SPS00
a raíz de	L_SPS00
a reculones	L_RG
a regaña dientes	L_RG
a regañadientes	L_RG
a rehala	L_RG
a rembolso	L_RG
a remiendos	L_RG
a remo	L_RG
a remojo	L_RG
a renglón seguido	L_RG
a reo	L_RG
a repecho	L_RG
a repelo	L_RG
a repelones	L_RG
a reserva de	L_SPS00
a resto abierto	L_RG
a retaguardia de	L_SPS00
a revienta cinchas	L_RG
a rienda suelta	L_RG
a riesgo de	L_SPS00
a riesgo y ventura	L_RG
a rodeabrazo	L_RG
a rompejunta	L_RG
a rostro firme	L_RG
a ruche	L_RG
a río revuelto	L_RG
a sabiendas	L_RG
a salto de mata	L_RG
a saltos	L_RG
a sangre caliente	L_RG
a sangre fría	L_RG
a sangre y fuego	L_RG
a santo de qué	L_RG
a sardinel	L_RG
a seguir bien	L_RG
a semejanza de	L_SPS00
a so capa	L_RG
a sobre haz	L_RG
a sobre peine	L_RG
a sobremano	L_RG
a socapa	L_RG
a soga	L_RG
a solapo	L_RG
a solas	L_RG
a solaz	L_RG
a sotamano	L_RG
a sotavento	L_RG
a su imagen y semejanza	L_RG
a suplicación de	L_SPS00
a sus anchas	L_RG
a súplica de	L_SPS00
a tal punto que	L_CS
a teja vana	L_RG
a tenor de	L_SPS00
a tientas	L_RG
a tiento	L_RG
a tirada	L_RG
a tiro de ballesta	L_RG
a tiro de pistola	L_RG
a tiro limpio	L_RG
a tizón	L_RG
a toca ropa	L_RG
a toca teja	L_RG
a tocateja	L_RG
a toda brida	L_RG
a toda costa	L_RG
a toda furia	L_RG
a toda hostia	L_RG
a toda leche	L_RG
a toda ley	L_RG
a toda marcha	L_RG
a toda mecha	L_RG
a toda máquina	L_RG
a toda pastilla	L_RG
a toda plana	L_RG
a toda prisa	L_RG
a toda rienda	L_RG
a todas estas	L_RG
a todas horas	L_RG
a todo andar	L_RG
a todo correr	L_RG
a todo evento	L_RG
a todo gas	L_RG
a todo lo largo	L_RG
a todo lo largo de	L_SPS00
a todo meter	L_RG
a todo moler	L_RG
a todo pasto	L_RG
a todo riesgo	L_RG
a todo ruedo	L_RG
a todo tirar	L_RG
a todo trance	L_RG
a todo vapor	L_RG
a tontas y a locas	L_RG
a topa tolondro	L_RG
a tope	L_RG
a toque de campana	L_RG
a torna peón	L_RG
a torna punta	L_RG
a torno	L_RG
a traición	L_RG
a trancas y barrancas	L_RG
a trancos	L_RG
a traque barraque	L_RG
a través de	L_SPS00
a trompa y talega	L_RG
a trompicones	L_RG
a tropezones	L_RG
a trueco de	L_SPS00
a trueque	L_RG
a tuertas	L_RG
a tuertas o a derechas	L_RG
a tuerto o a derecho	L_RG
a tutiplén	L_RG
a título de	L_SPS00
a ultranza	L_RG
a un lado de	L_SPS00
a un lado y otro	L_RG
a un solo efecto	L_RG
a uno y otro lado	L_RG
a upa	L_RG
a usanza de	L_SPS00
a veces	L_RG
a vez que	L_CS
a vida o muerte	L_RG
a vista de pájaro	L_RG
a viva voz	L_RG
a voz en cuello	L_RG
a voz en grito	L_RG
a vuela pluma	L_RG
a vuelapluma	L_RG
a vuelco de dado	L_RG
a vuelta de	L_SPS00
a vuelta de correo	L_RG
a vuelta de ojo	L_RG
a vuelta de ojos	L_RG
ab initio	L_RG
ab intestato	L_RG
ab ovo	L_RG
abastecimiento de agua	L_NCMS000
abastecimiento de agua potable	L_NCMS000
abogado defensor	L_NC
academia de bellas artes	L_NC
accidente de trabajo	L_NC
accidente laboral	L_NC
acción educativa	L_NC
acción militar	L_NC
acción pública	L_NC
aceite de oliva virgen	L_NCMS000
acerca de	L_SPS00
acre pie	L_NC
acta de nacimiento	L_NC
acta final	L_NC
actividad artística	L_NC
actividad económica	L_NC
actividad empresarial	L_NC
actividad extraescolar	L_NC
actividad financiera	L_NC
actividad humana	L_NC
actividad industrial	L_NC
actividad pesquera	L_NC
actividades al aire libre	L_NCFP000
acto administrativo	L_NC
acto impugnado	L_NC
acto jurídico	L_NC
actuación administrativa	L_NC
actuación judicial	L_NC
acuerdo de paz	L_NC
acuerdo internacional	L_NC
ad hoc	L_RG
ad interim	L_RG
ad lib	L_RG
ad libitum	L_RG
ad litem	L_RG
ad litteram	L_RG
ad quadrantum	L_RG
ad triangulum	L_RG
ad valorem	L_RG
además de	L_SPS00
además de eso	L_RG
además de que	L_CS
administración civil	L_NC
administración del estado	L_NC
administración educativa	L_NC
administración general	L_NC
administración municipal	L_NC
aeropuerto internacional	L_NC
agencia de protección de datos	L_NC
agencia de viajes	L_NC
agencia espacial europea	L_NCFS000
agenda electrónica	L_NC
agente social	L_NC
agresión sexual	L_NC
agua destilada	L_NCFS000
agua dulce	L_NCFS000
agua subterránea	L_NC
agua superficial	L_NC
aguas continentales	L_NCFP000
aguas pluviales	L_NCFP000
aguas territoriales	L_NCFP000
ahora bien	L_RG
ahí es nada	L_RG
ahí le duele	L_RG
aire puro	L_NCMS000
aislamiento térmico	L_NC
al abrigo de	L_SPS00
al alcance de la mano	L_RG
al alimón	L_RG
al apa	L_RG
al avemaría	L_RG
al bies	L_RG
al cabo de	L_SPS00
al calor de	L_SPS00
al carboncillo	L_RG
al cargo de	L_SPS00
al centro de	L_SPS00
al chas chas	L_RG
al cien por cien	L_RG
al cierre del ejercicio	L_RG
al clarear el día	L_RG
al compás de	L_SPS00
al conjuro de	L_SPS00
al correr de la pluma	L_RG
al correr del tiempo	L_RG
al decir de	L_SPS00
al derredor de	L_SPS00
al desbarate	L_RG
al descuido y con cuidado	L_RG
al desgaire	L_RG
al detall	L_RG
al estricote	L_RG
al filo de	L_SPS00
al filo de mediodía	L_RG
al fin de la jornada	L_RG
al fin y a la postre	L_RG
al fin y al cabo	L_RG
al frente de	L_SPS00
al gratén	L_RG
al grill	L_RG
al gusto de	L_SPS00
al hilo	L_RG
al hilo de mediodía	L_RG
al hilo del viento	L_RG
al igual que	L_CS
al interior de	L_SPS00
al libre albedrío	L_RG
al lucero del alba	L_RG
al mejor tiempo	L_RG
al modo de	L_SPS00
al objeto de	L_SPS00
al olor de	L_SPS00
al otro lado de	L_SPS00
al par que	L_CS
al paso que	L_CS
al paño	L_RG
al pie de fábrica	L_RG
al pie de la cuesta	L_RG
al pie de la letra	L_RG
al pie de la obra	L_RG
al poco rato	L_RG
al por mayor	L_RG
al por menor	L_RG
al primer envite	L_RG
al primer folio	L_RG
al primer gallo	L_RG
al primer golpe de vista	L_RG
al primer impulso	L_RG
al punto que	L_CS
al rape	L_RG
al raso	L_RG
al rededor	L_RG
al retortero	L_RG
al rojo blanco	L_RG
al rojo cereza	L_RG
al sesgo	L_RG
al socaire	L_RG
al socaire de	L_SPS00
al tanto de	L_SPS00
al temple	L_RG
al tendido	L_RG
al tenor de	L_SPS00
al tiempo que	L_CS
al tresbolillo	L_RG
al volateo	L_RG
alcaldía mayor	L_NCFS000
alcohol etílico	L_NCMS000
alguna que otra vez	L_RG
algunas veces	L_RG
alguno que otro	L_RG
alianza estratégica	L_NC
allende de	L_SPS00
allá se andan	L_RG
allá se las avenga	L_RG
allá se las componga	L_RG
allá se las haya	L_RG
allá se las hayan	L_RG
allá se van	L_RG
alma humana	L_NC
altar mayor	L_NCMS000
alto comisionado de las naciones unidas para los refugiados	L_NCMN000
alto el fuego	L_NCMS000
ambiente de trabajo	L_NC
ambiente familiar	L_NC
ambiente social	L_NC
anatomía humana	L_NCMS000
anatomía patológica	L_NCMS000
ancho de banda	L_NCMS000
animal salvaje	L_NC
antecedente personal	L_NC
anterior a	L_SPS00
antes bien	L_RG
antes pues	L_RG
antes que nada	L_RG
antiguo régimen	L_NCMS000
antropología cultural	L_NCMS000
antropología filosófica	L_NCMS000
anuario estadístico	L_NCMS000
análisis clínico	L_NC
análisis comparativo	L_NC
análisis cualitativo	L_NC
análisis cuantitativo	L_NC
análisis de datos	L_NCMN000
análisis de sangre	L_NCMN000
análisis del discurso	L_NCMN000
análisis económico	L_NC
análisis estadístico	L_NC
análisis funcional	L_NC
análisis histórico	L_NC
análisis químico	L_NC
apartado de correos	L_NC
aparte de	L_SPS00
aplicación informática	L_NC
apoyo docente	L_NC
apoyo escolar	L_NC
apoyo financiero	L_NC
apoyo logístico	L_NC
apoyo psicológico	L_NC
apoyo social	L_NC
apoyo técnico	L_NC
aprendizaje significativo	L_NCMS000
archivo general	L_NC
arma biológica	L_NC
arma nuclear	L_NC
arma química	L_NC
arquitecto técnico	L_NC
arquitectura popular	L_NCFS000
arreglo floral	L_NC
arroz blanco	L_NCMS000
art nouveau	L_NCMS000
arte contemporáneo	L_NCCS000
arte dramático	L_NCCS000
arte medieval	L_NCCS000
arte moderno	L_NCCS000
arte popular	L_NC
artes aplicadas	L_NCCP000
artes audiovisuales	L_NCCP000
asamblea general	L_NCFS000
asamblea general extraordinaria	L_NCFS000
asamblea general ordinaria	L_NCFS000
asamblea nacional constituyente	L_NCFS000
asamblea plenaria	L_NCFS000
asamblea popular	L_NCFS000
asesor fiscal	L_NC
asesor jurídico	L_NC
asesor legal	L_NC
asesor técnico	L_NC
asesoría jurídica	L_NC
asesoría legal	L_NC
asilo político	L_NCMS000
asistencia legal	L_NC
asistencia sanitaria	L_NCFS000
asistencia técnica	L_NCFS000
asma bronquial	L_NCFS000
asociación civil	L_NC
asociación de empresarios	L_NC
asociación de vecinos	L_NC
asociación empresarial	L_NC
asociación profesional	L_NC
así como también	L_RG
así como tampoco	L_RG
así pues	L_RG
así y todo	L_RG
atención al cliente	L_NCFS000
atención directa	L_NCFS000
atención domiciliaria	L_NCFS000
atención médica	L_NCFS000
atención personal	L_NCFS000
atención sanitaria	L_NCFS000
atención temprana	L_NCFS000
audición y lenguaje	L_NCFS000
audiencia nacional	L_NCFS000
audiencia provincial	L_NC
auditoría de cuentas	L_NC
auditoría externo	L_NC
auditoría interno	L_NC
aula de informática	L_NC
aumento de precio	L_NC
automóvil club	L_NCMS000
autonomía personal	L_NCFS000
autoridad laboral	L_NC
autorización expresa	L_NC
autorización judicial	L_NC
autorización previa	L_NC
ayer noche	L_RG
ayuda a domicilio	L_NCFS000
ayuda humanitaria	L_NCFS000
ayuda oficial	L_NC
año de servicio	L_NC
año fiscal	L_NC
año natural	L_NC
año sabático	L_NC
aún así	L_RG
aún con eso	L_RG
aún cuando	L_RG
bajo cuerda	L_RG
bajo el poder de	L_SPS00
bajo juramento	L_RG
bajo la responsabilidad de	L_SPS00
bajo llave	L_RG
bajo mano	L_RG
bajo ningún concepto	L_RG
bajo siete llaves	L_RG
banco bilbao vizcaya argentaria	L_NCMS000
banco central europeo	L_NCMS000
banco de pruebas	L_NC
banco de sangre	L_NC
banco mundial	L_NCMS000
banco nacional	L_NCMS000
banco santander central hispano	L_NCMS000
banda ancha	L_NCFS000
bandera nacional	L_NC
bandera roja	L_NCFS000
base de cálculo	L_NC
base jurídica	L_NC
biblioteca pública	L_NC
bien de capital	L_NC
bien entendido que	L_CS
bien mirado	L_RG
bien patrimonial	L_NC
bien público	L_NC
bien que mal	L_RG
bien sabe Dios que	L_CS
bienestar social	L_NCMS000
biología molecular	L_NCMS000
bioquímica clínica	L_NCMS000
bloqueo económico	L_NCMS000
boca arriba	L_RG
boletín oficial de navarra	L_NCMS000
boletín oficial del estado	L_NCMS000
bolsa de comercio	L_NCFS000
bolsa de plástico	L_NC
bosque tropical	L_NC
buzón de correo	L_NC
buzón de correo electrónico	L_NC
bóbilis bóbilis	L_RG
cada cosa por su lado	L_RG
cada dos por tres	L_RG
cadena de producción	L_NC
cadena de tiendas	L_NC
caja de herramientas	L_NC
calidad asistencial	L_NCFS000
calidad de vida	L_NCFS000
calidad del agua	L_NCFS000
cambio climático	L_NCMS000
cambio de gobierno	L_NC
cambio de uso	L_NCMS000
campaña de promoción	L_NC
campaña electoral	L_NC
campaña política	L_NC
campeonato mundial	L_NC
campeonato nacional	L_NC
campeón mundial	L_NC
campo de aplicación	L_NC
campo de fútbol	L_NC
campo de golf	L_NC
campo de juego	L_NC
campo eléctrico	L_NC
campo magnético	L_NC
campus universitario	L_NC
canción de amor	L_NC
cantidad de energía	L_NCFS000
cantidad de información	L_NCFS000
capacidad creativa	L_NC
capacidad de aprendizaje	L_NCFS000
capacidad de obrar	L_NCFS000
capacidad jurídica	L_NC
capacidad legal	L_NC
capacidad operativa	L_NC
capital de riesgo	L_NCFS000
capital humano	L_NCFS000
capital riesgo	L_NCFS000
captura de datos	L_NC
cara a cara	L_RG
cara abajo	L_RG
cara arriba	L_RG
carga de trabajo	L_NC
carga eléctrica	L_NC
carnet de conducir	L_NC
carpe diem	L_RG
carta apostólica	L_NC
carta certificada	L_NC
carta de las naciones unidas	L_NCFS000
carta magna	L_NC
cartera de clientes	L_NC
cartera de valores	L_NC
casa rural	L_NC
casi geostrófico	L_RG
casi que	L_CS
celebración eucarística	L_NC
censo de población	L_NC
central hidroeléctrica	L_NC
central nuclear	L_NC
central térmica	L_NC
centro asistencial	L_NC
centro cívico	L_NC
centro de atención al cliente	L_NC
centro de documentación	L_NC
centro de día	L_NC
centro de gestión	L_NC
centro de rehabilitación	L_NC
centro escolar	L_NC
centro hospitalario	L_NC
centro penitenciario	L_NC
centímetro Fh s	L_NC
centímetro Fh segundo	L_NC
centímetro cuadrado	L_NC
centímetro cúbico	L_NC
centímetro cúbico Fh segundo	L_NC
centímetro cúbico por segundo	L_NC
centímetro de hg	L_NC
centímetro de mercurio	L_NC
centímetro por segundo	L_NC
centímetro segundo	L_NC
cepillo de dientes	L_NC
ceremonia de clausura	L_NC
certificado de asistencia	L_NC
certificado de estudios	L_NC
certificado de nacimiento	L_NC
cheque certificado	L_NC
chino mandarín	L_NC
chorro de agua	L_NC
ciclo económico	L_NC
ciclo formativo	L_NC
ciclo vital	L_NC
cien por cien	L_RG
ciencia biológica	L_NC
ciencia de la educación	L_NC
ciencia de la naturaleza	L_NC
ciencia empresarial	L_NC
ciento por ciento	L_RG
ciento y la madre	L_RG
cifra de negocio	L_NC
cine de terror	L_NCMS000
cine documental	L_NCMS000
cine erótico	L_NCMS000
cine fantástico	L_NCMS000
cinta adhesiva	L_NCFS000
circuito cerrado	L_NC
circulación sanguínea	L_NCFS000
cirugía torácica	L_NCFS000
cirugía vascular	L_NCFS000
clase obrera	L_NCFS000
clase política	L_NCFS000
clase social	L_NC
clase trabajadora	L_NC
claustro de profesores	L_NC
clave de acceso	L_NC
clima mediterráneo	L_NCMS000
clima templado	L_NCMS000
clima tropical	L_NCMS000
cm Fh s	L_NCFS000
cm3 Fh s	L_NCFS000
cm3 Fh seg	L_NCFS000
cochite hervite	L_RG
codo a codo	L_RG
codo con codo	L_RG
colección privada	L_NC
colegio de abogados	L_NC
colegio nacional	L_NC
colegio público	L_NC
comandante en jefe	L_NCCS000
comercio bilateral	L_NCMS000
comercio justo	L_NCMS000
comisiones obreras	L_NCFP000
comisión asesora	L_NC
comisión de evaluación	L_NC
comisión de gobierno	L_NC
comisión económica	L_NC
comisión ejecutiva	L_NC
comisión europea	L_NCFS000
comisión mixta	L_NC
comisión nacional del mercado de valores	L_NCFS000
comisión negociadora	L_NC
comisión paritaria	L_NC
comisión parlamentaria	L_NC
comité central del partido	L_NCMS000
comité económico y social	L_NCMS000
comité ejecutivo	L_NCMS000
comité olímpico internacional	L_NCMS000
comité organizador	L_NCMS000
como Pedro por su casa	L_RG
como a los ojos de su cara	L_RG
como a real de enemigo	L_RG
como ahora es de día	L_RG
como alma que lleva el diablo	L_RG
como caído de las nubes	L_RG
como de la noche al día	L_RG
como dos y dos son cuatro	L_RG
como el convidado de piedra	L_RG
como el día a la noche	L_RG
como el perro y el gato	L_RG
como es de día	L_RG
como es debido	L_RG
como estamos aquí tú y yo	L_RG
como está mandado	L_RG
como hay Dios	L_RG
como hecho de encargo	L_RG
como la palma de la mano	L_RG
como los chorros del oro	L_RG
como mucho	L_RG
como mínimo	L_RG
como oro en paño	L_RG
como por ensalmo	L_RG
como que	L_CS
como quien dice	L_RG
como quien no quiere la cosa	L_RG
como quien oye llover	L_RG
como quiera que	L_CS
como si no hubiera dicho nada	L_RG
como si tal cosa	L_RG
como un pepe	L_RG
compact disc	L_NCMS000
compañero de equipo	L_NC
compañía aérea	L_NC
compañía de jesús	L_NCFS000
compensación económica	L_NC
complejo turístico	L_NC
comportamiento humano	L_NCMS000
comportamiento sexual	L_NC
comportamiento social	L_NC
composición musical	L_NC
comprensión lectora	L_NCFS000
compromiso político	L_NC
comunicación de datos	L_NCFS000
comunicación oral	L_NCFS000
comunicación verbal	L_NCFS000
comunidad económica europea	L_NCFS000
comunidad europea	L_NCFS000
comunidad humana	L_NC
con carácter de	L_SPS00
con claridad meridiana	L_RG
con conocimiento de causa	L_RG
con creces	L_RG
con efecto desde	L_SPS00
con el culo al aire	L_RG
con el ojo tan largo	L_RG
con el sudor de la frente	L_RG
con excepción de	L_SPS00
con honores de	L_SPS00
con la ayuda de Dios	L_RG
con la boca abierta	L_RG
con la casa a cuestas	L_RG
con la condición de	L_SPS00
con la espada desnuda	L_RG
con la frente alta	L_RG
con la frente bien alta	L_RG
con la frente levantada	L_RG
con la lengua de un palmo	L_RG
con la lengua fuera	L_RG
con la mano en el corazón	L_RG
con la música a otra parte	L_RG
con la soga al cuello	L_RG
con la vida en un hilo	L_RG
con las manos cruzadas	L_RG
con las manos vacías	L_RG
con las orejas caídas	L_RG
con las orejas gachas	L_RG
con las orejas tan largas	L_RG
con las piernas cruzadas	L_RG
con lo que respecta a	L_SPS00
con los cinco sentidos	L_RG
con los ojos cerrados	L_RG
con los pies delante	L_RG
con mal pie	L_RG
con mala idea	L_RG
con mano escasa	L_RG
con mano pesada	L_RG
con mil amores	L_RG
con miquis	L_RG
con miras a	L_SPS00
con moto	L_RG
con mucho gusto	L_RG
con objeto de	L_SPS00
con objeto que	L_CS
con ocasión de	L_SPS00
con pelos y señales	L_RG
con pies de plomo	L_RG
con puntos y comas	L_RG
con relación a	L_SPS00
con respecto a	L_SPS00
con respecto de	L_SPS00
con solo que	L_CS
con sordina	L_RG
con tal de	L_SPS00
con tal de que	L_CS
con tal que	L_CS
con toda la barba	L_RG
con toda la boca	L_RG
con toda normalidad	L_RG
con todas las de la ley	L_RG
con todo y con eso	L_RG
con un palmo de lengua	L_RG
con uñas y dientes	L_RG
con valor de	L_SPS00
con viento fresco	L_RG
con vistas a	L_SPS00
con zurrapas	L_RG
concesión administrativa	L_NC
conciencia colectiva	L_NCFS000
conciencia nacional	L_NCFS000
conciencia pública	L_NCFS000
conciencia social	L_NCFS000
concilio vaticano II	L_NCMN000
condiciones ambientales	L_NCFP000
condiciones atmosféricas	L_NCFP000
condiciones de venta	L_NCFP000
condiciones de vida	L_NCFP000
condiciones económicas	L_NCFP000
condiciones generales	L_NCFP000
conducta humana	L_NCFS000
conexión a la red	L_NCFS000
conferencia episcopal	L_NCFS000
conferencia mundial	L_NCFS000
conflicto armado	L_NC
conflicto social	L_NC
conforme a	L_SPS00
congregación para la doctrina de la fe	L_NCMN000
congreso eucarístico	L_NCMS000
congreso nacional	L_NCMS000
conocimiento científico	L_NCMS000
conocimiento humano	L_NCMS000
consecutio temporum	L_RG
consejo de estado	L_NC
consejo de europa	L_NCMS000
consejo de la unión europea	L_NCMS000
consejo de ministros	L_NC
consejo de seguridad	L_NCMS000
consejo de seguridad de las naciones unidas	L_NCMS000
consejo directivo	L_NC
consejo económico y social	L_NCMS000
consejo ejecutivo	L_NC
consejo municipal	L_NC
consejo nacional	L_NC
consejo permanente	L_NC
conservatorio de música	L_NC
construcción naval	L_NCFS000
consulta popular	L_NC
contabilidad financiera	L_NCFS000
contaminación acústica	L_NCFS000
contaminación ambiental	L_NCFS000
contaminación atmosférica	L_NCFS000
contaminación del agua	L_NCFS000
contra reloj	L_RG
contra rembolso	L_RG
contra viento y marea	L_RG
contratación de personal	L_NCFS000
contrato de obra	L_NC
contrato social	L_NC
control de flujo	L_NCMS000
control de gestión	L_NCMS000
control médico	L_NC
control numérico	L_NCMS000
convención de ginebra	L_NCMS000
convención europea	L_NC
cooperación económica	L_NCFS000
coordenadas geográficas	L_NCFS000
copa de europa	L_NC
copa intercontinental	L_NC
corpore insepulto	L_RG
correlación de fuerzas	L_NCFS000
correo basura	L_NCFS000
correo no deseado	L_NCFS000
corte suprema	L_NCFS000
cortes generales	L_NCFP000
corteza cerebral	L_NCFS000
cosa juzgada	L_NCFS000
crecimiento de la población	L_NCMS000
crecimiento urbano	L_NCMS000
crisis económica	L_NC
cruz roja	L_NCFS000
cruz roja internacional	L_NCFS000
crédito personal	L_NC
cuanto antes	L_RG
cubierta vegetal	L_NC
cuello uterino	L_NCMS000
cuenta de ahorro	L_NC
cuenta de pérdidas y ganancias	L_NC
cuenta de resultados	L_NC
cuerpo de bomberos	L_NC
cuerpo diplomático	L_NC
cuerpo docente	L_NC
cuerpo legislativo	L_NC
cuidado médico	L_NC
cultura clásica	L_NCFS000
cum laude	L_AQ0CN0
curso académico	L_NC
curso intensivo	L_NC
cálamo currente	L_RG
cámara alta	L_NCFS000
cámara baja	L_NCFS000
cámara de representantes	L_NCFS000
cámara web	L_NC
código de comercio	L_NC
código de identificación	L_NC
código fuente	L_NCMS000
código genético	L_NCMS000
código ético	L_NC
córam pópulo	L_RG
da capo	L_RG
dado que	L_CS
darse de alta	L_RG
dato económico	L_NC
dato personal	L_NC
datos bancario	L_NC
daño cerebral	L_NC
daño material	L_NC
de Dios abajo	L_RG
de a folio	L_RG
de a veras	L_RG
de acarreo	L_RG
de acuerdo con	L_SPS00
de acá para allá	L_RG
de ahí que	L_CS
de al lado de	L_SPS00
de alto copete	L_RG
de alto coturno	L_RG
de altos vuelos	L_RG
de amplio espectro	L_RG
de andar por casa	L_RG
de anequín	L_RG
de antemano	L_RG
de aquí en adelante	L_RG
de aquí para allí	L_RG
de aquí que	L_CS
de armas tomar	L_RG
de arrastre	L_RG
de arte mayor	L_RG
de arte menor	L_RG
de aúpa	L_RG
de baja estofa	L_RG
de bajo vuelo	L_RG
de balde	L_RG
de ballesta	L_RG
de barra a barra	L_RG
de boca en boca	L_RG
de bote en bote	L_RG
de bracero	L_RG
de bruces	L_RG
de buen efecto	L_RG
de buen grado	L_RG
de buen tono	L_RG
de buena cepa	L_RG
de buena familia	L_RG
de buena fe	L_RG
de buena gana	L_RG
de buena ley	L_RG
de buena ropa	L_RG
de buena voluntad	L_RG
de buenas a primeras	L_RG
de bureo	L_RG
de bóbilis	L_RG
de cabo a rabo	L_RG
de canto	L_RG
de cara a	L_SPS00
de carrerilla	L_RG
de carretilla	L_RG
de cascabel gordo	L_RG
de casquería	L_RG
de cañutillo	L_RG
de chipén	L_RG
de churro	L_RG
de ciencia cierta	L_RG
de circunvalación	L_RG
de consuno	L_RG
de corredera	L_RG
de cortos vuelos	L_RG
de coña	L_RG
de cuajo	L_RG
de cualquier forma	L_RG
de cuando en cuando	L_RG
de cuelga	L_RG
de cuenta y riesgo	L_RG
de cuerpo presente	L_RG
de cutio	L_RG
de debajo de	L_SPS00
de delante de	L_SPS00
de dentro de	L_SPS00
de detrás de	L_SPS00
de dientes afuera	L_RG
de disparo	L_RG
de doble filo	L_RG
de dos en dos	L_RG
de dos filos	L_RG
de día en día	L_RG
de ensueño	L_RG
de entonces acá	L_RG
de estampía	L_RG
de este lado de	L_SPS00
de extranjis	L_RG
de facto	L_RG
de falondres	L_RG
de fogueo	L_RG
de fuera de	L_SPS00
de golpe y porrazo	L_RG
de grado en grado	L_RG
de guagua	L_RG
de guardarropía	L_RG
de guillotina	L_RG
de higos a brevas	L_RG
de hoy en adelante	L_RG
de hoy para mañana	L_RG
de hoz y de coz	L_RG
de ida y vuelta	L_RG
de iure	L_RG
de jure	L_RG
de juro	L_RG
de la cruz a la fecha	L_RG
de la mano de	L_SPS00
de la noche a la mañana	L_RG
de la puñeta	L_RG
de la zona de	L_SPS00
de lado a lado	L_RG
de lance en lance	L_RG
de lengua en lengua	L_RG
de lo contrario	L_RG
de lo lindo	L_RG
de lo vivo a lo pintado	L_RG
de madrugada	L_RG
de mal a mal	L_RG
de mal abrigo	L_RG
de mal efecto	L_RG
de mal en peor	L_RG
de mal grado	L_RG
de mal tono	L_RG
de mal vivir	L_RG
de mala fe	L_RG
de mala gana	L_RG
de mala ley	L_RG
de mala manera	L_RG
de mala muerte	L_RG
de mala nota	L_RG
de mancomún	L_RG
de mano derecha	L_RG
de mano en mano	L_RG
de mano izquierda	L_RG
de manos a boca	L_RG
de marca mayor	L_RG
de marras	L_RG
de matute	L_RG
de media gala	L_RG
de medio a medio	L_RG
de medio lado	L_RG
de medio ojo	L_RG
de medio pie	L_RG
de mentirijillas	L_RG
de mil amores	L_RG
de mil diablos	L_RG
de miranda	L_RG
de misa y olla	L_RG
de modo que	L_CS
de momio	L_RG
de morondanga	L_RG
de muchas campanillas	L_RG
de muchas leguas	L_RG
de mucho efecto	L_RG
de mucho trote	L_RG
de más marca	L_RG
de mírame y no me toques	L_RG
de ninguna manera	L_RG
de nueva planta	L_RG
de nuevo cuño	L_RG
de nunca acabar	L_RG
de oque	L_RG
de oreja a oreja	L_RG
de oro y azul	L_RG
de oídas	L_RG
de pacotilla	L_RG
de padre y muy señor mío	L_RG
de palabra en palabra	L_RG
de pascuas a ramos	L_RG
de pe a pa	L_RG
de pega	L_RG
de pelo en pecho	L_RG
de perdidos al río	L_RG
de perilla	L_RG
de perillas	L_RG
de persona a persona	L_RG
de pie de banco	L_RG
de pies a cabeza	L_RG
de pilón	L_RG
de pitiminí	L_RG
de pleno derecho	L_RG
de poca monta	L_RG
de poca ropa	L_RG
de poco más o menos	L_RG
de poco pelo	L_RG
de poder a poder	L_RG
de polo a polo	L_RG
de pontifical	L_RG
de popa a proa	L_RG
de por junto	L_RG
de por medio	L_RG
de por sí	L_RG
de por vida	L_RG
de postín	L_RG
de potencia en potencia	L_RG
de primera clase	L_RG
de primera intención	L_RG
de primera línea	L_RG
de prisa	L_RG
de prisa y corriendo	L_RG
de pro	L_RG
de propia minerva	L_RG
de propio puño	L_RG
de puerta a puerta	L_RG
de puerta en puerta	L_RG
de puertas adentro	L_RG
de puertas afuera	L_RG
de puertos allende	L_RG
de puertos aquende	L_RG
de punta a cabo	L_RG
de punta a punta	L_RG
de pura cepa	L_RG
de puta madre	L_RG
de puta pena	L_RG
de putifa	L_RG
de puño y letra	L_RG
de quedo	L_RG
de quita y pon	L_RG
de rama en rama	L_RG
de raro en raro	L_RG
de rato en rato	L_RG
de rebato	L_RG
de rebote	L_RG
de rechupete	L_RG
de refilón	L_RG
de relumbrón	L_RG
de repelón	L_RG
de repente	L_RG
de repuesto	L_RG
de reserva	L_RG
de resultas	L_RG
de retrocarga	L_RG
de revuelo	L_RG
de rodilla en rodilla	L_RG
de rompe y rasga	L_RG
de rondón	L_RG
de seguida	L_RG
de segunda mano	L_RG
de sentido común	L_RG
de so capa	L_RG
de sobra	L_RG
de sobresalto	L_RG
de sol a sol	L_RG
de soslayo	L_RG
de suerte que	L_CS
de tal manera que	L_CS
de tapadillo	L_RG
de tarde en tarde	L_RG
de tiempo en tiempo	L_RG
de tiento en tiento	L_RG
de todas maneras	L_RG
de todas todas	L_RG
de todo corazón	L_RG
de todo en todo	L_RG
de todo punto	L_RG
de todos los diablos	L_RG
de todos modos	L_RG
de través	L_RG
de trazo continuo	L_RG
de trecho en trecho	L_RG
de tres al cuarto	L_RG
de tú a tú	L_RG
de ultratumba	L_RG
de un día a otro	L_RG
de un jalón	L_RG
de un lado a otro	L_RG
de un lado para otro	L_RG
de un plumazo	L_RG
de un primer voleo	L_RG
de un tirón	L_RG
de una manera o de otra	L_RG
de una sentada	L_RG
de una tacada	L_RG
de una tirada	L_RG
de una vez para siempre	L_RG
de uno en uno	L_RG
de uso externo	L_RG
de uvas a peras	L_RG
de vez en cuando	L_RG
de visu	L_RG
de viva voz	L_RG
de volatería	L_RG
de vértigo	L_RG
de vía estrecha	L_RG
de órdago	L_RG
debajo de	L_SPS00
debate parlamentario	L_NC
debido a	L_SPS00
declaración de guerra	L_NCFS000
declaración de principios	L_NCFS000
declaración jurada	L_NC
decreto ley	L_NC
del otro lado	L_RG
del otro lado de	L_SPS00
del poder de	L_SPS00
del primer voleo	L_RG
del principio al fin	L_RG
del revés	L_RG
del tiempo de Maricastaña	L_RG
delante de	L_SPS00
delante de Dios y de todo el	L_RG
delegación territorial	L_NC
delito doloso	L_NCMS000
demanda agregada	L_NCFS000
demanda de empleo	L_NC
demandante de empleo	L_NC
democracia participativa	L_NCFS000
denominación social	L_NCFS000
deo gracias	L_I
deo volente	L_RG
departamento de agricultura	L_NCMS000
departamento de educación	L_NCMS000
departamento de industria , comercio y turismo	L_NCMS000
departamento de justicia	L_NCMS000
departamento de medio ambiente	L_NCMS000
dependencia económica	L_NCFS000
deporte de aventura	L_NC
deporte profesional	L_NCMS000
depuración de aguas	L_NCMS000
depuración de aguas residuales	L_NCMS000
derecho a participar	L_NCMS000
derecho adquirido	L_NC
derecho civil	L_NC
derecho de asociación	L_NCMS000
derecho de autodeterminación	L_NCMS000
derecho de familia	L_NCMS000
derecho de huelga	L_NCMS000
derecho de petición	L_NCMS000
derecho de uso	L_NCMS000
derecho de voto	L_NCMS000
derecho del hombre	L_NC
derecho fiscal	L_NCMS000
derecho fundamental	L_NC
derecho humano	L_NC
derecho individual	L_NCMS000
derecho nacional	L_NCMS000
derecho natural	L_NCMS000
derecho político	L_NC
derecho positivo	L_NCMS000
derecho privado	L_NCMS000
derecho público	L_NCMS000
derecho subjetivo	L_NCMS000
derecho tributario	L_NCMS000
desarrollo de la personalidad	L_NCMS000
desarrollo económico	L_NCMS000
desarrollo rural	L_NCMS000
desarrollo urbano	L_NCMS000
desastre ecológico	L_NC
desastre natural	L_NC
descarga eléctrica	L_NC
desde cero	L_RG
desde el momento en que	L_CS
desde luego	L_RG
desde niño	L_RG
desde que el mundo es mundo	L_RG
detrás de	L_SPS00
diagnóstico clínico	L_NC
diagnóstico médico	L_NC
diagnóstico precoz	L_NC
diario oficial de la unión europea	L_NCMS000
dibujo animado	L_NC
dictadura militar	L_NC
dieta equilibrada	L_NC
dietética y nutrición	L_NCMS000
dignidad humana	L_NCFS000
dirección a	L_SPS00
dirección administrativa	L_NCFS000
dirección de recursos humanos	L_NCFS000
dirección del viento	L_NCFS000
dirección general	L_NCFS000
dirección general de carreteras	L_NCFS000
dirección general de cultura	L_NCFS000
dirección general de los registros y del notariado	L_NCFS000
dirección general de seguros	L_NCFS000
dirección general de servicios	L_NCFS000
dirección general de tráfico	L_NCFS000
dirección ip	L_NCFS000
dirección url	L_NCFS000
director adjunto	L_NC
director administrativo	L_NC
director artístico	L_NC
director de fotografía	L_NC
director de orquesta	L_NC
director general	L_NC
director gerente	L_NC
director técnico	L_NC
directorio raíz	L_NCFS000
disc jockey	L_NCFS000
diseño asistido por ordenador	L_NCMS000
diseño editorial	L_NCMS000
diseño industrial	L_NCMS000
disfunción eréctil	L_NC
disposición legal	L_NC
distribución espacial	L_NCFS000
distribución geográfica	L_NCFS000
distribución normal	L_NCFS000
distrito electoral	L_NC
diversidad biológica	L_NCFS000
división de poderes	L_NCFS000
dióxido de azufre	L_NCFS000
dióxido de carbono	L_NCFS000
do ut des	L_RG
doble imposición	L_NCCS000
doble nacionalidad	L_NCCS000
doctor en derecho	L_NC
documentación administrativa	L_NCFS000
documento de identidad	L_NC
documento html	L_NCMS000
dolor de cabeza	L_NC
domiciliación bancaria	L_NC
domicilio legal	L_NCMS000
domicilio social	L_NCMS000
dotación presupuestaria	L_NC
droga ilícita	L_NC
duración del contrato	L_NCFS000
duty free	L_AQ0CN0
día de acción de gracias	L_NCMS000
día de descanso	L_NC
día de fiesta	L_NC
eclipse total	L_NC
economía aplicada	L_NCFS000
economía de escala	L_NC
economía de la salud	L_NCFS000
economía doméstica	L_NCFS000
economía española	L_NCFS000
economía familiar	L_NCFS000
economía general	L_NCFS000
economía informal	L_NCFS000
economía internacional	L_NCFS000
economía mixta	L_NCFS000
economía mundial	L_NCFS000
economía nacional	L_NCFS000
economía política	L_NCFS000
economía regional	L_NCFS000
economía social	L_NCFS000
edad adulta	L_NCFS000
edad de jubilación	L_NCFS000
edad de oro	L_NCFS000
edad escolar	L_NCFS000
edad media	L_NC
edición limitada	L_NC
edificio central	L_NC
edificio principal	L_NC
educación ambiental	L_NCFS000
educación artística	L_NCFS000
educación de adultos	L_NCFS000
educación escolar	L_NCFS000
educación formal	L_NCFS000
educación general básica	L_NCFS000
educación infantil	L_NCFS000
educación infantil y primaria	L_NCFS000
educación intercultural	L_NCFS000
educación obligatoria	L_NCFS000
educación para el desarrollo	L_NCFS000
educación para la salud	L_NCFS000
educación preescolar	L_NCFS000
educación primaria	L_NCFS000
educación religiosa	L_NCFS000
educación sanitaria	L_NCFS000
educación secundaria	L_NCFS000
educación secundaria obligatoria	L_NCFS000
educación sexual	L_NCFS000
educación vial	L_NCFS000
efecto directo	L_NC
efecto especial	L_NC
eje principal	L_NC
eje y	L_NCMS000
ejecución de sentencia	L_NCFS000
ejercicio económico	L_NC
ejercicio físico	L_NC
ejército de liberación	L_NCMS000
ejército de liberación nacional	L_NCMS000
ejército de tierra	L_NCMS000
ejército nacional	L_NCMS000
ejército popular	L_NCMS000
ejército zapatista de liberación nacional	L_NCMS000
elecciones al parlamento europeo	L_NCFP000
elecciones libres	L_NCFP000
elecciones parlamentarias	L_NCFP000
elección presidencial	L_NCFS000
eliminación de residuos	L_NCFS000
emergencia social	L_NC
emisión de bonos	L_NC
emisión de gases	L_NC
empleo estable	L_NC
empresa comercial	L_NC
empresa constructora	L_NC
empresa de servicios	L_NC
empresa de transporte	L_NC
empresa estatal	L_NC
empresa familiar	L_NC
empresa industrial	L_NC
empresa multinacional	L_NC
empresa privada	L_NC
empresa pública	L_NC
en Dios y en conciencia	L_RG
en agraz	L_RG
en aquel entonces	L_RG
en aras de	L_SPS00
en atención a	L_SPS00
en babia	L_RG
en batería	L_RG
en berlina	L_RG
en buena lid	L_RG
en buenos términos	L_RG
en busca de	L_SPS00
en calidad de	L_SPS00
en cambio de	L_SPS00
en caso de	L_SPS00
en caso de que	L_CS
en cierto modo	L_RG
en compañía de	L_SPS00
en compensación de	L_SPS00
en concepto de	L_SPS00
en consecuencia	L_RG
en contorno	L_RG
en contra de	L_SPS00
en contracambio	L_RG
en coña	L_RG
en cuanto a	L_SPS00
en cuanto que	L_CS
en cuclillas	L_RG
en cuerpo y alma	L_RG
en cuestión de	L_SPS00
en círculo	L_RG
en defecto de	L_SPS00
en demanda de	L_SPS00
en demasía	L_RG
en derredor de	L_SPS00
en desbandada	L_RG
en descargo	L_RG
en desquite	L_RG
en detalle	L_RG
en diferido	L_RG
en dirección a	L_SPS00
en el centro de	L_SPS00
en el entorno de	L_SPS00
en el interior de	L_SPS00
en el otro lado de	L_SPS00
en el plazo de	L_SPS00
en el puesto de	L_SPS00
en el supuesto que	L_CS
en entredicho	L_RG
en espera de	L_SPS00
en este mismo instante	L_RG
en evitación de	L_SPS00
en favor de	L_SPS00
en fiado	L_RG
en fila india	L_RG
en fin de cuentas	L_RG
en franquía	L_RG
en gracia a	L_SPS00
en gran manera	L_RG
en gran medida	L_RG
en guisa de	L_SPS00
en honor a la verdad	L_RG
en horre	L_RG
en interés	L_RG
en junto	L_RG
en la línea de	L_SPS00
en la necesidad de	L_SPS00
en la temporada de	L_SPS00
en la zona de	L_SPS00
en las cercanías de	L_SPS00
en las proximidades de	L_SPS00
en limpio	L_RG
en lo concerniente a	L_SPS00
en lo sucesivo	L_RG
en lontananza	L_RG
en los buenos tiempos	L_RG
en lugar de	L_SPS00
en lugar de que	L_CS
en línea	L_RG
en líneas generales	L_RG
en mala hora	L_RG
en mangas de camisa	L_RG
en manos de	L_SPS00
en materia de	L_SPS00
en medio de	L_SPS00
en memoria de	L_SPS00
en menos de	L_SPS00
en miniatura	L_RG
en mitad de	L_SPS00
en modo alguno	L_RG
en obligación de	L_SPS00
en obsequio a	L_SPS00
en obsequio de	L_SPS00
en oferta	L_RG
en oposición a	L_SPS00
en orden a	L_SPS00
en paralelo	L_RG
en parte por	L_SPS00
en partes iguales	L_RG
en paños menores	L_RG
en pelota picada	L_RG
en pie de guerra	L_RG
en plan de	L_SPS00
en plantilla	L_RG
en pocas palabras	L_RG
en porretas	L_RG
en pos de	L_SPS00
en prenda	L_RG
en primicia	L_RG
en pro de	L_SPS00
en procura	L_RG
en prueba de	L_SPS00
en punto de caramelo	L_RG
en puridad	L_RG
en rama	L_RG
en razón de	L_SPS00
en recuerdo de	L_SPS00
en rededor	L_RG
en remojo	L_RG
en representación de	L_SPS00
en resumidas cuentas	L_RG
en ristre	L_RG
en salvo	L_RG
en seguida	L_RG
en señal de	L_SPS00
en sordina	L_RG
en su defecto	L_RG
en tanto que	L_CS
en tiempo de	L_SPS00
en tiempo diferido	L_RG
en tiempo real	L_RG
en tiempo récord	L_RG
en tiempo y forma	L_RG
en toda la extensión de la palabra	L_RG
en toda regla	L_RG
en toda tierra de garbanzos	L_RG
en todo caso	L_RG
en todo lo descubierto	L_RG
en torno a	L_SPS00
en torno de	L_SPS00
en touche	L_RG
en tromba	L_RG
en tándem	L_RG
en un abrir y cerrar de ojos	L_RG
en un decir amén	L_RG
en un pis-pas	L_RG
en un pispás	L_RG
en un tris	L_RG
en vez de	L_SPS00
en vez de que	L_CS
en vilo	L_RG
en virtud de	L_SPS00
en vista de	L_SPS00
en vista de que	L_CS
en volandas	L_RG
en vías de	L_SPS00
en zigzag	L_RG
encefalopatía espongiforme bovina	L_NCFS000
encima de	L_SPS00
encuesta de opinión	L_NC
endocrinología y nutrición	L_NCFS000
energía eólica	L_NCFS000
energía térmica	L_NCFS000
enfermedad grave	L_NC
enfermedad profesional	L_NC
enfrente de	L_SPS00
ensayo clínico	L_NC
enseñanza básica	L_NCFS000
enseñanza de idiomas	L_NCFS000
enseñanza media	L_NCFS000
ente público	L_NCFS000
entidad gestora	L_NCFS000
entidad pública	L_NCFS000
entorno de red	L_NCMS000
entorno social	L_NCMS000
entrada gratuita	L_NCFS000
entre la espada y la pared	L_RG
entre la vida y la muerte	L_RG
entre pecho y espalda	L_RG
entre que	L_CS
entre tanto que	L_CS
entrega de premios	L_NC
entrenamiento físico	L_NCMS000
equilibrio ecológico	L_NCMS000
equipo de fútbol	L_NC
equipo de protección	L_NC
equipo de sonido	L_NC
equipo directivo	L_NC
equipo docente	L_NC
equipo informático	L_NC
equipo nacional	L_NC
erario público	L_NCMS000
es hablar por demás	L_RG
escala de valores	L_NC
esclerosis múltiple	L_NCMS000
escuela de arte	L_NC
escuela de bellas artes	L_NC
escuela de música	L_NC
escuela oficial de idiomas	L_NCFS000
escuela rural	L_NC
escuela taller	L_NC
espacio económico europeo	L_NCMS000
espacio en blanco	L_NC
especie humana	L_NCFS000
esperando a	L_SPS00
estabilidad económica	L_NCFS000
estabilidad política	L_NCFS000
estación de autobús	L_NC
estación de ferrocarril	L_NC
estación de tren	L_NC
estación meteorológica	L_NC
estadio olímpico	L_NC
estado anímico	L_NCMS000
estado de salud	L_NCMS000
estado del bienestar	L_NCMS000
estado democrático	L_NC
estado emocional	L_NCMS000
estado federal	L_NC
estado independiente	L_NC
estado miembro de la unión europea	L_NC
estado nacional	L_NC
estado sólido	L_NCMS000
estadística descriptiva	L_NCFS000
estatutos sociales	L_NCMP000
estructura de datos	L_NC
estructura económica	L_NCFS000
estructura familiar	L_NC
estructura jerárquica	L_NCFS000
estructura social	L_NCFS000
estudio de grabación	L_NC
estudio de impacto	L_NC
estudio económico	L_NC
estudios empresariales	L_NCMP000
evaluación continua	L_NC
evaluación del impacto ambiental	L_NC
evaluación del riesgo	L_NC
evaluación externa	L_NC
evidencia científica	L_NC
ex abrupto	L_RG
ex aequo	L_RG
ex ante	L_AQ0CN0
ex cathedra	L_RG
ex cáthedra	L_RG
ex post	L_AQ0CN0
ex profeso	L_RG
ex testamento	L_RG
excepto que	L_CS
exceso de velocidad	L_NC
expansión económica	L_NCFS000
expediente disciplinario	L_NC
explotación agrícola	L_NC
exposición itinerante	L_NC
exposición permanente	L_NC
expresión artística	L_NCFS000
expresión escrita	L_NCFS000
expresión oral	L_NCFS000
expresión plástica	L_NCFS000
extrema derecha	L_NCFS000
factor ambiental	L_NC
factor de riesgo	L_NC
facultad de bellas artes	L_NCFS000
facultad de derecho	L_NCFS000
facultad de psicología	L_NCFS000
fal Fh s	L_NCFS000
falso testimonio	L_NC
farmacología clínica	L_NCFS000
fauna marina	L_NCFS000
fe cristiana	L_NCFS000
fecha de cierre	L_NC
fecha de emisión	L_NC
fecha de solicitud	L_NC
fecha límite	L_NC
fecha tope	L_NC
federación nacional	L_NC
ficha técnica	L_NC
fichero de datos	L_NC
figura jurídica	L_NC
filología clásica	L_NCFS000
filosofía de la ciencia	L_NCFS000
filosofía del derecho	L_NCFS000
filosofía política	L_NCFS000
final feliz	L_NC
fiscal jefe	L_NC
flujo de aire	L_NCFS000
flujo de caja	L_NCFS000
flujo de datos	L_NCFS000
flujo de fondos	L_NCFS000
flujo de información	L_NCFS000
fondo de garantía	L_NC
fondo de pensiones	L_NC
fondo documental	L_NC
fondo europeo de desarrollo	L_NCMS000
fondo monetario internacional	L_NCMS000
fondo social europeo	L_NCMS000
forma gráfica	L_NC
formación humana	L_NCFS000
formación ocupacional	L_NCFS000
formación profesional específica	L_NCFS000
formación profesional ocupacional	L_NCFS000
formato html	L_NCFS000
fosa nasal	L_NC
fotografía aérea	L_NCFS000
frame relay	L_NCFS000
frecuencia cardiaca	L_NC
frente nacional	L_NCFS000
frente popular	L_NCFS000
fruta fresca	L_NCFS000
fruto seco	L_NC
ft Fh h	L_NCFS000
ft Fh min	L_NCFS000
ft Fh s	L_NCFS000
ft Fh s2	L_NCFS000
ft3 Fh min	L_NCFS000
ft3 Fh s	L_NCFS000
fuente de alimentación	L_NC
fuente de datos	L_NC
fuente de energía	L_NC
fuente de financiación	L_NC
fuente de luz	L_NC
fuera de que	L_CS
fuerza física	L_NCFS000
fuerza militar	L_NCFS000
fuerzas de ocupación	L_NCFP000
fuerzas de seguridad	L_NCFP000
fuerzas y cuerpos de seguridad	L_NCFP000
fuga de capitales	L_NCFS000
full time	L_AQ0CN0
full time	L_RG
función administrativa	L_NC
fundamento jurídico	L_NC
fundamentos de derecho	L_NCMP000
física aplicada	L_NCFS000
física nuclear	L_NCFS000
física teórica	L_NCFS000
fútbol base	L_NCMS000
g Fh l	L_NCMP000
g Fh m3	L_NCMP000
gabinete técnico	L_NC
gal Fh ac Fh d	L_NCFS000
gal Fh cap Fh d	L_NCFS000
gal Fh d	L_NCFS000
gal Fh ft2	L_NCFS000
gal Fh ft2 Fh min	L_NCFS000
gal Fh ft2 d	L_NCFS000
gal Fh h	L_NCFS000
gal Fh min	L_NCFS000
galería comercial	L_NC
galón Fh acre Fh día	L_NC
galón Fh acre día	L_NC
galón Fh acre por día	L_NC
galón Fh cápita Fh día	L_NC
galón Fh cápita día	L_NC
galón Fh cápita por día	L_NC
galón Fh día	L_NC
galón Fh hora	L_NC
galón Fh minuto	L_NC
galón Fh pie cuadrado	L_NC
galón Fh pie cuadrado Fh día	L_NC
galón Fh pie cuadrado Fh minuto	L_NC
galón Fh pie cuadrado día	L_NC
galón Fh pie cuadrado minuto	L_NC
galón Fh pie cuadrado por día	L_NC
galón Fh pie cuadrado por minuto	L_NC
galón Fh segundo	L_NC
galón acre Fh día	L_NC
galón acre por día	L_NC
galón cápita Fh día	L_NC
galón cápita por día	L_NC
galón día	L_NC
galón hora	L_NC
galón minuto	L_NC
galón per cápita Fh día	L_NC
galón per cápita día	L_NC
galón per cápita por día	L_NC
galón pie cuadrado Fh día	L_NC
galón pie cuadrado Fh minuto	L_NC
galón pie cuadrado por día	L_NC
galón pie cuadrado por minuto	L_NC
galón por acre Fh día	L_NC
galón por acre día	L_NC
galón por acre por día	L_NC
galón por acre y día	L_NC
galón por cápita Fh día	L_NC
galón por cápita día	L_NC
galón por cápita por día	L_NC
galón por día	L_NC
galón por hora	L_NC
galón por minuto	L_NC
galón por pie cuadrado	L_NC
galón por pie cuadrado Fh día	L_NC
galón por pie cuadrado Fh minuto	L_NC
galón por pie cuadrado día	L_NC
galón por pie cuadrado minuto	L_NC
galón por pie cuadrado por día	L_NC
galón por pie cuadrado por minuto	L_NC
galón por pie cuadrado y día	L_NC
galón por pie cuadrado y minuto	L_NC
galón por segundo	L_NC
galón segundo	L_NC
gama de productos	L_NC
ganancia neta	L_NC
garantía constitucional	L_NCFS000
garantía hipotecaria	L_NCFS000
gastos corrientes	L_NCMP000
gastos de administración	L_NCMP000
gastos de capital	L_NCMP000
gastos de funcionamiento	L_NCMP000
gastos de gestión	L_NCMP000
gastos de mantenimiento	L_NCMP000
gastos de personal	L_NCMP000
gastos de transporte	L_NCMP000
gastos de viaje	L_NCMP000
gastos fijos	L_NCMP000
gastos financieros	L_NCMP000
gastos públicos	L_NCMP000
gastos sociales	L_NCMP000
geografía física	L_NCFS000
geografía humana	L_NCFS000
geometría analítica	L_NCFS000
gestión administrativa	L_NCFS000
gestión clínica	L_NCFS000
gestión de datos	L_NCFS000
gestión de la empresa	L_NCFS000
gestión de personal	L_NCFS000
gestión económica	L_NCFS000
gestión educativa	L_NCFS000
gestión empresarial	L_NCFS000
gestión interna	L_NCFS000
gestión medioambiental	L_NCFS000
gestión sanitaria	L_NCFS000
gestión urbanística	L_NCFS000
gimnasia artística	L_NCFS000
giro postal	L_NC
globalización de la economía	L_NCFS000
gobierno central	L_NCMS000
gobierno civil	L_NCMS000
gobierno constitucional	L_NCMS000
gobierno federal	L_NCMS000
gobierno local	L_NCMS000
gobierno militar	L_NCMS000
gobierno provisional	L_NCMS000
gobierno revolucionario	L_NCMS000
golpe militar	L_NC
gracia de dios	L_NCFS000
gracias a	L_SPS00
gracias a que	L_CS
gracias al que	L_CS
grado celsius	L_NC
grado centígrado	L_NC
grado de madurez	L_NCMS000
grado farenheit	L_NC
grado kelvin	L_NC
gramo Fh litro	L_NC
gramo Fh metro cúbico	L_NC
gramo por litro	L_NC
gramo por metro cúbico	L_NC
gripe aviar	L_NCFS000
grosso modo	L_RG
grupo de edad	L_NC
grupo de empresas	L_NC
grupo de noticias	L_NC
grupo de trabajo	L_NC
grupo social	L_NC
guardería infantil	L_NC
guardia civil	L_NC
guardia nacional	L_NC
guerra civil española	L_NCFS000
guerra fría	L_NC
guerra mundial	L_NC
guía de turismo	L_NC
guía didáctica	L_NC
género literario	L_NC
hab Fh km	L_NCFS000
habitación doble	L_NC
habitación individual	L_NC
habitante Fh km2	L_NC
habitante Fh kms2	L_NC
habitante por kilómetro cuadrado	L_NC
habitante por km2	L_NC
hacia mediados de	L_SPS00
hacienda pública	L_NCFS000
hasta cierto punto	L_RG
hasta cuando	L_CS
hasta más ver	L_RG
hasta tanto que	L_CS
hecho imponible	L_NCMS000
hechos de los apóstoles	L_NCMP000
herramientas de gestión	L_NCFP000
hic et nunc	L_RG
high tech	L_AQ0CN0
higiene bucal	L_NCFP000
hijo pródigo	L_NC
hipótesis de trabajo	L_NCFN000
historia clínica	L_NC
historia de la educación	L_NCFS000
historia de la filosofía	L_NCFS000
historia del arte	L_NCFS000
historia económica	L_NCFS000
hoja de papel	L_NC
hoja informativa	L_NC
honoris causa	L_AQ0CN0
horario de atención al público	L_NCMS000
horario de clases	L_NCMS000
horario de mañana	L_NCMS000
horario de verano	L_NCMS000
horario laboral	L_NCMS000
horas de oficina	L_NCFP000
horas de sol	L_NCFP000
horas hábiles	L_NCFP000
horno microondas	L_NC
hospital general	L_NCMS000
hospital infantil	L_NC
huella digital	L_NC
humanidades y ciencias sociales	L_NCFP000
humedad relativa	L_NCFS000
hábito alimentario	L_NC
id. de usuario	L_NCMS000
identidad nacional	L_NC
identidad sexual	L_NCFS000
iglesia anglicana	L_NCFS000
iglesia católica	L_NCFS000
iglesia evangélica	L_NCFS000
iglesia ortodoxa	L_NCFS000
iglesia universal	L_NCFS000
igualdad de derechos	L_NCFS000
igualdad de oportunidades	L_NCFS000
igualdad entre hombres y mujeres	L_NCFS000
igualdad social	L_NCFS000
imagen de marca	L_NCFS000
imagen personal	L_NCFS000
impacto ambiental	L_NC
impacto medioambiental	L_NC
impacto visual	L_NC
imperio de la ley	L_NCMS000
impreso de solicitud	L_NC
impuesto de sociedades	L_NCMS000
impuesto sobre actividades económicas	L_NCMS000
impuesto sobre bienes inmuebles	L_NCMS000
impuesto sobre el valor añadido	L_NCMS000
impuesto sobre la renta	L_NCMS000
impuesto sobre la renta de las personas físicas	L_NCMS000
impuesto sobre sociedades	L_NCMS000
impuesto sobre transmisiones patrimoniales	L_NCMS000
in Fh s2	L_NCFS000
in aeternum	L_RG
in albis	L_RG
in artículo mortis	L_RG
in crescendo	L_RG
in extenso	L_RG
in extremis	L_RG
in fieri	L_RG
in fraganti	L_RG
in illo tempore	L_RG
in illo témpore	L_RG
in memóriam	L_RG
in partibus	L_AQ0CN0
in pectore	L_RG
in perpétuum	L_RG
in promptu	L_RG
in pártibus infidélium	L_RG
in péctore	L_RG
in púribus	L_RG
in situ	L_RG
in sólidum	L_RG
in vitro	L_AQ0CN0
in vitro	L_RG
in vivo	L_AQ0CN0
in vivo	L_RG
in ánima vili	L_RG
incapacidad laboral	L_NCFS000
incapacidad permanente	L_NCFS000
incapacidad temporal	L_NCFS000
incontinencia urinaria	L_NCFS000
incremento salarial	L_NC
industria nacional	L_NCFS000
industria química	L_NCFS000
influencia política	L_NCFS000
información adicional	L_NCFS000
información general	L_NCFS000
información genética	L_NCFS000
información tecnológica	L_NCFS000
información turística	L_NCFS000
informe de auditoría	L_NC
informe de evaluación	L_NC
informe de gestión	L_NC
informática de gestión	L_NCFS000
ingeniero agrónomo	L_NC
ingeniero químico	L_NC
ingeniero técnico agrícola	L_NC
ingeniería química	L_NCMS000
iniciativa legislativa	L_NC
inmediatamente después de	L_SPS00
inspector general	L_NC
instituto nacional de empleo	L_NCMS000
instituto nacional de la salud	L_NCMS000
instituto nacional de la seguridad social	L_NCMS000
instituto nacional de meteorología	L_NCMS000
instrucciones de uso	L_NCFP000
instrumento musical	L_NC
integración económica	L_NCFS000
integración social	L_NCFS000
inteligencia humana	L_NCFS000
inter nos	L_RG
inter vivos	L_RG
interacción social	L_NCFS000
intercambio de datos	L_NCMS000
interfaz de usuario	L_NC
intervalo de tiempo	L_NC
intervención quirúrgica	L_NC
interés social	L_NCMS000
investigación clínica	L_NCFS000
ipso facto	L_RG
ipso jure	L_RG
jefe de gabinete	L_NC
jefe de proyecto	L_NC
jefe de seguridad	L_NC
jefe de unidad	L_NC
jefe militar	L_NC
joule Fh K	L_NC
joule Fh grado kelvin	L_NC
joule Fh kelvin	L_NC
joule por grado kelvin	L_NC
joule por kelvin	L_NC
jubilación anticipada	L_NC
juego de mesa	L_NC
juegos olímpicos	L_NCMP000
juicio oral	L_NC
junta general de accionistas	L_NCFS000
junta militar	L_NCFS000
junto a	L_SPS00
junto con	L_SPS00
jurisdicción contencioso-administrativa	L_NCFS000
jurisdicción ordinaria	L_NCFS000
jurisdicción penal	L_NCFS000
juro a bríos	L_RG
justicia ordinaria	L_NCFS000
justicia social	L_NCFS000
kg Fh cm2	L_NCMP000
kg Fh m2	L_NCMP000
kg Fh m3	L_NCMP000
kg Fh s	L_NCFS000
kilogramo Fh centímetro cuadrado	L_NC
kilogramo Fh metro cuadrado	L_NC
kilogramo Fh metro cúbico	L_NC
kilogramo Fh segundo	L_NC
kilogramo por centímetro cuadrado	L_NC
kilogramo por metro cuadrado	L_NC
kilogramo por metro cúbico	L_NC
kilogramo por segundo	L_NC
kilómetro Fh h	L_NC
kilómetro Fh h Fh s	L_NC
kilómetro Fh hora	L_NC
kilómetro Fh hora Fh segundo	L_NC
kilómetro Fh hora por segundo	L_NC
kilómetro Fh hora segundo	L_NC
kilómetro Fh s	L_NC
kilómetro Fh segundo	L_NC
kilómetro cuadrado	L_NC
kilómetro hora Fh segundo	L_NC
kilómetro hora por segundo	L_NC
kilómetro hora segundo	L_NC
kilómetro por hora	L_NC
kilómetro por hora Fh segundo	L_NC
kilómetro por hora por segundo	L_NC
kilómetro por segundo	L_NC
kilómetro segundo	L_NC
km Fh h	L_NCFS000
km Fh h Fh s	L_NCFS000
kn Fh s	L_NCFS000
l Fh d	L_NCFS000
l Fh día	L_NCFS000
l Fh m2	L_NCFS000
l Fh m2 Fh d	L_NCFS000
l Fh m2 Fh min	L_NCFS000
l Fh m2 Fh s	L_NCFS000
l Fh min	L_NCFS000
l Fh s	L_NCFS000
la madre tierra	L_NCMS000
labor docente	L_NCFS000
laboratorio clínico	L_NC
lactancia materna	L_NCFS000
laudo arbitral	L_NCFS000
lb Fh ft2	L_NCFP000
lb Fh ft3	L_NCFP000
lb Fh in2	L_NCFP000
lb Fh milgal	L_NCFP000
leche de vaca	L_NCFS000
lector de cd	L_NC
legislación autonómica	L_NC
legislación nacional	L_NC
legislación vigente	L_NC
legítima defensa	L_NCFS000
lejos de	L_SPS00
lengua extranjera	L_NC
lengua internacional	L_NC
lengua oficial	L_NC
lenguaje corporal	L_NCMS000
lenguaje de programación	L_NC
lenguaje escrito	L_NCMS000
lenguaje oral	L_NCMS000
ley de procedimiento administrativo	L_NCFS000
ley del suelo	L_NCFS000
ley fundamental	L_NCFS000
ley general	L_NCFS000
ley general de educación	L_NCFS000
ley general presupuestaria	L_NCFS000
ley general tributaria	L_NCFS000
ley marco	L_NCFS000
ley orgánica del poder judicial	L_NCFS000
ley vigente	L_NC
libertad de asociación	L_NCFS000
libertad de expresión	L_NCFS000
libertad de opinión	L_NCFS000
libertad de pensamiento	L_NCFS000
libertad de prensa	L_NCFS000
libertad religiosa	L_NCFS000
libertades fundamentales	L_NCFP000
libra Fh milgalón	L_NC
libra Fh pie cuadrado	L_NC
libra Fh pie cúbico	L_NC
libra Fh pulgada cuadrada	L_NC
libra fuerza	L_NC
libra milgalón	L_NC
libra por milgalón	L_NC
libra por pie cuadrado	L_NC
libra por pie cúbico	L_NC
libra por pulgada cuadrada	L_NC
licencia de obras	L_NC
liga árabe	L_NCFS000
literatura juvenil	L_NCFS000
litro Fh día Fh cápita	L_NC
litro Fh día por cápita	L_NC
litro Fh metro cuadrado	L_NC
litro Fh metro cuadrado Fh dia	L_NC
litro Fh metro cuadrado Fh minuto	L_NC
litro Fh metro cuadrado Fh segundo	L_NC
litro Fh metro cuadrado por dia	L_NC
litro Fh metro cuadrado por minuto	L_NC
litro Fh metro cuadrado por segundo	L_NC
litro Fh minuto	L_NC
litro Fh segundo	L_NC
litro día cápita	L_NC
litro día per cápita	L_NC
litro día por cápita	L_NC
litro metro cuadrado por día	L_NC
litro metro cuadrado por minuto	L_NC
litro metro cuadrado por segundo	L_NC
litro por día	L_NC
litro por día Fh cápita	L_NC
litro por día cápita	L_NC
litro por día per cápita	L_NC
litro por día por cápita	L_NC
litro por metro cuadrado	L_NC
litro por metro cuadrado Fh dia	L_NC
litro por metro cuadrado Fh minuto	L_NC
litro por metro cuadrado Fh segundo	L_NC
litro por metro cuadrado día	L_NC
litro por metro cuadrado minuto	L_NC
litro por metro cuadrado por dia	L_NC
litro por metro cuadrado por minuto	L_NC
litro por metro cuadrado por segundo	L_NC
litro por metro cuadrado segundo	L_NC
litro por metro cuadrado y día	L_NC
litro por metro cuadrado y minuto	L_NC
litro por metro cuadrado y segundo	L_NC
litro por minuto	L_NC
litro por segundo	L_NC
lluvia torrencial	L_NC
lo de menos	L_RG
lo malo es que	L_CS
lo uno por lo otro	L_RG
local comercial	L_NC
loco citato	L_RG
lt Fh d per càpita	L_NCFS000
lt Fh d por càpita	L_NCFS000
lt Fh m2	L_NCFS000
lt Fh m2 Fh d	L_NCFS000
lt Fh m2 Fh min	L_NCFS000
lt Fh m2 Fh s	L_NCFS000
lucha armada	L_NCFS000
lucha por el poder	L_NCFS000
lucro cesante	L_NCMS000
luego que	L_CS
lugar de nacimiento	L_NC
luz blanca	L_NC
línea de acción	L_NC
línea eléctrica	L_NC
línea fija	L_NCFS000
m Fh s	L_NCFS000
m3 Fh h	L_NCFS000
m3 Fh ha Fh d	L_NCFS000
m3 Fh hora	L_NCFS000
m3 Fh m2 Fh d	L_NCFS000
m3 Fh m2 Fh h	L_NCFS000
m3 Fh s	L_NCFS000
m3 Fh seg	L_NCFS000
madre naturaleza	L_NCFS000
madre soltera	L_NC
maguer que	L_CS
mal a mal	L_RG
manu militari	L_RG
mapa topográfico	L_NC
marco de referencia	L_NC
marco general	L_NCMS000
margen bruto	L_NCCS000
matemática aplicada	L_NC
material complementario	L_NC
material de oficina	L_NCMS000
material eléctrico	L_NCMS000
material escrito	L_NCMS000
material plástico	L_NCMS000
matrimonio civil	L_NC
mecánica cuántica	L_NCFS000
mecánica de fluidos	L_NCFS000
medalla de bronce	L_NC
medalla de oro	L_NC
medalla de plata	L_NC
media jornada	L_NCFS000
mediana empresa	L_NCFS000
medicina de urgencias	L_NCFS000
medicina general	L_NCFS000
medicina interna	L_NCFS000
medicina natural	L_NCFS000
medicina nuclear	L_NCFS000
medida de seguridad	L_NC
medio ambiente	L_NCMS000
medio de transporte	L_NC
medio natural	L_NCMS000
medio rural	L_NCMS000
medio urbano	L_NCMS000
medios de comunicación	L_NCMP000
medios de comunicación de masas	L_NCMP000
medios económicos	L_NCMP000
memoria anual	L_NCFS000
memoria ram	L_NCFS000
memoria virtual	L_NCFS000
mensaje de correo electrónico	L_NC
mensaje de error	L_NC
mensaje electrónico	L_NC
mercado abierto	L_NCMS000
mercado bursátil	L_NC
mercado secundario	L_NCMS000
merced a que	L_CS
mesa de negociación	L_NC
metro Fh s	L_NC
metro Fh segundo	L_NC
metro cuadrado	L_NC
metro cúbico Fh hora	L_NC
metro cúbico Fh segundo	L_NC
metro cúbico por hora	L_NC
metro cúbico por segundo	L_NC
metro por segundo	L_NC
metro segundo	L_NC
mi Fh h	L_NCFS000
miembro del consejo	L_NC
miembro del partido	L_NC
miembro titular	L_NC
mientras que	L_CS
milla Fh hora	L_NC
milla cuadrado	L_NC
milla por hora	L_NC
milímetro cuadrado	L_NC
milímetro cúbico	L_NC
milímetro de hg	L_NC
milímetro de mercurio	L_NC
ministerio de asuntos exteriores	L_NCMS000
ministerio de educación y ciencia	L_NCMS000
ministerio de hacienda	L_NCMS000
ministerio de justicia	L_NCMS000
ministro de asuntos exteriores	L_NC
ministro de hacienda	L_NC
ministro de obras públicas	L_NC
mirando a	L_SPS00
mirando hacia	L_SPS00
misión comercial	L_NCFS000
ml Fh d	L_NCFS000
mlt Fh d	L_NCFS000
mobiliario urbano	L_NCFS000
modelo conceptual	L_NC
modelo de gestión	L_NC
modelo económico	L_NC
modelo matemático	L_NC
modelo oficial	L_NC
modelo teórico	L_NC
modificación de datos	L_NC
moneda nacional	L_NCFS000
moneda única	L_NCFS000
monóxido de carbono	L_NCFS000
mortalidad infantil	L_NCFS000
mortis causa	L_RG
motor de búsqueda	L_NC
motor eléctrico	L_NC
motu proprio	L_AQ0CN0
motu proprio	L_RG
movilidad geográfica	L_NCFS000
movimiento de resistencia	L_NCMS000
movimiento internacional	L_NCMS000
movimiento nacional	L_NCMS000
movimiento obrero	L_NCMS000
movimiento revolucionario	L_NCMS000
muerte violenta	L_NC
muestra representativa	L_NCFS000
mundo material	L_NCMS000
mutatis mutandis	L_RG
muy de mañana	L_RG
máquina virtual	L_NC
más allá de	L_SPS00
más de la cuenta	L_RG
más valiera	L_RG
médico general	L_NC
médicos sin fronteras	L_NCMP000
método científico	L_NC
música de cámara	L_NCFS000
música electrónica	L_NCFS000
música moderna	L_NCFS000
música popular	L_NCFS000
música religiosa	L_NCFS000
naciones unidas	L_NCFP000
nada más y nada menos	L_RG
naturaleza humana	L_NCFS000
naturaleza jurídica	L_NCFS000
navegación aérea	L_NCFS000
navegación marítima	L_NCFS000
necesidad básica	L_NC
necesidades educativas especiales	L_NCFP000
negociación colectiva	L_NCFS000
new look	L_AQ0CN0
newton Fh metro cuadrado	L_NC
newton por metro cuadrado	L_NC
ni a la de tres	L_RG
ni a tiros	L_RG
ni aún	L_RG
ni corto ni perezoso	L_RG
ni fu ni fa	L_RG
ni hablar del peluquín	L_RG
ni mucho menos	L_RG
ni más ni menos	L_RG
ni que	L_CS
ni que decir tiene	L_RG
ni remotamente	L_RG
ni rey ni roque	L_RG
ni suena ni truena	L_RG
ni tan sólo	L_RG
ni tanto así	L_RG
ni tanto ni tan calvo	L_RG
ni tanto ni tan poco	L_RG
nivel de calidad	L_NC
nivel de confianza	L_NC
nivel de empleo	L_NCMS000
nivel de estudios	L_NCMS000
nivel de exigencia	L_NCMS000
nivel de precios	L_NCMS000
nivel de seguridad	L_NC
nivel de vida	L_NCMS000
nivel educativo	L_NCMS000
nivel técnico	L_NCMS000
no ha lugar	L_RG
no obstante	L_CC
no sea que	L_CS
nombre comercial	L_NC
nombre de usuario	L_NC
nombre del archivo	L_NC
norma básica	L_NC
norma jurídica	L_NC
normalización lingüística	L_NCFS000
normas de aplicación	L_NCFP000
normas de seguridad	L_NCFP000
normas sociales	L_NCFP000
normativa vigente	L_NCFS000
nota media	L_NC
nota simple	L_NCFS000
nueva economía	L_NCFS000
núcleo familiar	L_NC
número de alumnos	L_NCMS000
número de cuenta	L_NCMS000
número de identificación	L_NCMS000
número de identificación fiscal	L_NCMS000
número de profesores	L_NCMS000
números rojos	L_NCMP000
o sea	L_CC
obispo auxiliar	L_NC
obra de teatro	L_NC
obra nueva	L_NCFS000
obra social	L_NC
obras de infraestructura	L_NCFP000
observatorio astronómico	L_NC
ocupación militar	L_NCFS000
oferta educativa	L_NCFS000
off line	L_RG
oficina central	L_NCFS000
oficina de empleo	L_NC
oficina de información	L_NC
oficina principal	L_NCFS000
oficina técnica	L_NC
ola de calor	L_NCFS000
ola de frío	L_NCFS000
on line	L_RG
oncología médica	L_NCFS000
onza fluido	L_NC
opción de compra	L_NC
operación comercial	L_NC
operación militar	L_NC
operador o	L_NCFS000
operador y	L_NCFS000
orden constitucional	L_NCFS000
orden de prioridad	L_NCFS000
orden establecido	L_NCFS000
orden jurisdiccional	L_NCFS000
orden jurídico	L_NCFS000
orden ministerial	L_NCFS000
ordenación general del sistema educativo	L_NCFS000
ordenación urbana	L_NCFS000
ordenamiento jurídico	L_NCMS000
ordenanza fiscal	L_NC
ordenanza municipal	L_NC
organismo oficial	L_NC
organización de empresas	L_NC
organización de las naciones unidas	L_NCFS000
organización de las naciones unidas para la agricultura y la alimentación	L_NCFS000
organización de las naciones unidas para la educación, la ciencia y la cultura	L_NCFS000
organización de los estados americanos	L_NCFS000
organización sin fines de lucro	L_NC
organización social	L_NC
orientación educativa	L_NCFS000
oso hormiguero	L_NC
pacto social	L_NCMS000
padrón municipal	L_NCMS000
pago anticipado	L_NCMS000
pago en efectivo	L_NCMS000
paisaje natural	L_NCMS000
paisaje urbano	L_NCMS000
palacio de justicia	L_NCMS000
palacio de los deportes	L_NCMS000
pantalla de cristal liquido	L_NC
pantalla de cristal líquido	L_NC
papel continuo	L_NCMS000
para colmo	L_RG
para dar y tomar	L_RG
para más inri	L_RG
para que	L_CS
para rato	L_RG
para remate	L_RG
para todo trote	L_RG
parecido a	L_SPS00
parlamento europeo	L_NCMS000
parlamento vasco	L_NCMS000
parque de bomberos	L_NC
parque eólico	L_NC
parte contratante	L_NC
partida de nacimiento	L_NC
partido amistoso	L_NC
partido comunista	L_NCMS000
partido conservador	L_NCMS000
partido de ida	L_NC
partido de vuelta	L_NC
partido liberal	L_NCMS000
partido oficial	L_NCMS000
partido político	L_NC
partido socialista obrero español	L_NCMS000
parálisis cerebral	L_NC
pasado mañana	L_RG
pasión de cristo	L_NCFS000
patata frita	L_NC
patrimonio artístico	L_NC
patrimonio cultural	L_NC
patrimonio histórico-artístico	L_NC
país en desarrollo	L_NC
peccata minuta	L_AQ0CN0
pensamiento filosófico	L_NCMS000
pensión de jubilación	L_NC
pequeña empresa	L_NC
pequeñas y medianas empresas	L_NCFP000
per cápita	L_AQ0CN0
permiso de conducir	L_NC
permiso de residencia	L_NC
persona de edad avanzada	L_NC
personal administrativo	L_NCMS000
personal docente	L_NCMS000
personalidad jurídica	L_NCFS000
personalidad jurídica propia	L_NCFS000
perspectiva histórica	L_NCFS000
perspectivas económicas	L_NCFP000
período de vacaciones	L_NC
período de validez	L_NCMS000
período de vigencia	L_NCMS000
pescado fresco	L_NCMS000
pese a	L_SPS00
pese a que	L_CS
pie Fh hora	L_NC
pie Fh minuto	L_NC
pie Fh segundo	L_NC
pie Fh segundo Fh segundo	L_NC
pie Fh segundo por segundo	L_NC
pie Fh segundo segundo	L_NC
pie cuadrado	L_NC
pie cúbico	L_NC
pie cúbico Fh minuto	L_NC
pie cúbico Fh segundo	L_NC
pie cúbico por minuto	L_NC
pie cúbico por segundo	L_NC
pie de agua	L_NC
pie hora	L_NC
pie minuto	L_NC
pie por hora	L_NC
pie por minuto	L_NC
pie por segundo	L_NC
pie por segundo Fh segundo	L_NC
pie por segundo al cuadrado	L_NC
pie por segundo cuadrado	L_NC
pie por segundo por segundo	L_NC
pie por segundo segundo	L_NC
pie segundo	L_NC
pie segundo Fh segundo	L_NC
pie segundo por segundo	L_NC
pie segundo segundo	L_NC
piscina cubierta	L_NC
plan de emergencia	L_NC
plan de gestión	L_NC
plan general de contabilidad	L_NCMS000
planificación económica	L_NCFS000
planificación familiar	L_NCFS000
plano de situación	L_NCMS000
plazo de admisión	L_NC
pleno del ayuntamiento	L_NC
pleno empleo	L_NCMS000
pleno municipal	L_NC
población objetivo	L_NCFS000
poco a poco	L_RG
policía judicial	L_NCCS000
polígono industrial	L_NC
política ambiental	L_NC
política de defensa	L_NC
política de empleo	L_NC
política económica	L_NC
por adarmes	L_RG
por al lado de	L_SPS00
por amor de Dios	L_RG
por anticipado	L_RG
por aquel entonces	L_RG
por arte de birlibirloque	L_RG
por arte de magia	L_RG
por barba	L_RG
por carambola	L_RG
por causa de	L_SPS00
por ce o por be	L_RG
por ceremonia	L_RG
por concuerda	L_RG
por consecuencia	L_RG
por consiguiente	L_RG
por contera	L_RG
por cuatro reales	L_RG
por cuenta de	L_SPS00
por cuenta y riesgo	L_RG
por de contado	L_RG
por de pronto	L_RG
por debajo de	L_SPS00
por debajo de cuerda	L_RG
por decirlo así	L_RG
por delante de	L_SPS00
por dentro de	L_SPS00
por descontado	L_RG
por detrás de	L_SPS00
por duplicado	L_RG
por ejemplo	L_RG
por el centro de	L_SPS00
por el contrario	L_RG
por el otro lado de	L_SPS00
por en medio	L_RG
por ende	L_RG
por ensalmo	L_RG
por entonces	L_RG
por esos mundos de Dios	L_RG
por este lado de	L_SPS00
por favor	L_RG
por hache o por be	L_RG
por igual	L_RG
por intuito	L_RG
por la cuenta que	L_CS
por la gracia de Dios	L_RG
por lo bajines	L_RG
por lo bajini	L_RG
por lo bajinis	L_RG
por lo claro	L_RG
por lo común	L_RG
por lo general	L_RG
por lo menos	L_RG
por lo presente	L_RG
por lo pronto	L_RG
por lo tanto	L_RG
por medio de	L_SPS00
por minutos	L_RG
por motivo de	L_SPS00
por mucho que	L_CS
por más que digas	L_RG
por nada del mundo	L_RG
por ningún concepto	L_RG
por norma general	L_RG
por obra de	L_SPS00
por obra y gracia de	L_SPS00
por onzas	L_RG
por otro lado	L_RG
por oídas	L_RG
por pura fórmula	L_RG
por razón de que	L_CS
por real decreto	L_RG
por regla general	L_RG
por segundo año consecutivo	L_RG
por separado	L_RG
por si acaso	L_RG
por si las moscas	L_RG
por siempre jamás	L_RG
por supuesto	L_RG
por testa	L_RG
por todo lo alto	L_RG
por un tris	L_RG
por ventura	L_RG
por virtud de	L_SPS00
potencia de salida	L_NCFS000
potestad sancionadora	L_NCFS000
precio de mercado	L_NCMS000
precio máximo	L_NCMS000
precio mínimo	L_NCMS000
precio unitario	L_NCMS000
precio único	L_NCMS000
predicción del tiempo	L_NC
predicción meteorológica	L_NC
preparador físico	L_NC
presidencia del gobierno	L_NCFS000
presidente del consejo de administración	L_NC
presidente del parlamento	L_NCMS000
presión sanguínea	L_NCFS000
presupuesto aprobado	L_NC
presupuesto nacional	L_NC
prevención de riesgos	L_NCFS000
prevención de riesgos laborales	L_NCFS000
primer ministro	L_NC
primera comunión	L_NCFS000
primera guerra mundial	L_NCFS000
primero de mayo	L_NCMS000
primeros auxilios	L_NCMP000
principio de igualdad	L_NCMS000
principio de legalidad	L_NCMS000
principios generales del derecho	L_NCMP000
procedimiento administrativo	L_NC
procedimiento de evaluación	L_NC
procedimiento judicial	L_NC
procesamiento de la información	L_NCMP000
proceso administrativo	L_NC
proceso de datos	L_NCMS000
proceso de desarrollo	L_NCMS000
proceso de fabricación	L_NCMS000
proceso de integración	L_NCMS000
proceso de socialización	L_NCMS000
proceso educativo	L_NCMS000
producción agrícola	L_NC
producción cinematográfica	L_NC
producción editorial	L_NC
producción editorial	L_NCFS000
producto bruto	L_NCMS000
producto nacional	L_NC
producto químico	L_NC
profesor emérito	L_NC
profesor titular	L_NC
programa de las naciones unidas para el medio ambiente	L_NCMS000
programa gratuito	L_NC
programación general	L_NCMS000
progreso económico	L_NCMS000
promoción del empleo	L_NCFS000
promulgación de la ley	L_NCFS000
propiedad urbana	L_NCFS000
proposición de ley	L_NCFS000
proposición no de ley	L_NCFS000
prosperidad económica	L_NCFS000
protocolo de kioto	L_NCMS000
protocolo tcp-ip	L_NCFS000
protocolo tcp/ip	L_NCFS000
proyecto de ley	L_NC
proyecto empresarial	L_NC
prueba documental	L_NC
práctica clínica	L_NC
préstamo hipotecario	L_NC
psicología aplicada	L_NCFS000
psicología clínica	L_NCFS000
psicología cognitiva	L_NCFS000
psicología evolutiva	L_NCFS000
psicología general	L_NCFS000
psicología social	L_NCFS000
publicidad comercial	L_NCFS000
pues bien	L_RG
pues sí que	L_CS
pues sí que	L_I
puesta en servicio	L_NCFS000
pulgada Fh segundo Fh segundo	L_NC
pulgada Fh segundo por segundo	L_NC
pulgada Fh segundo segundo	L_NC
pulgada agua	L_NC
pulgada cuadrado	L_NC
pulgada cúbico	L_NC
pulgada de agua	L_NC
pulgada de hg	L_NC
pulgada hg	L_NC
pulgada por segundo Fh segundo	L_NC
pulgada por segundo al cuadrado	L_NC
pulgada por segundo cuadrado	L_NC
pulgada por segundo por segundo	L_NC
pulgada por segundo segundo	L_NC
pulgada segundo Fh segundo	L_NC
pulgada segundo por segundo	L_NC
pulgada segundo segundo	L_NC
punto crítico	L_NC
punto de cruz	L_NCMS000
punto de equilibrio	L_NCMS000
punto de partida	L_NCMS000
punto de referencia	L_NCMS000
punto focal	L_NCMS000
puntuación media	L_NCMS000
página personal	L_NC
página web	L_NC
página web personal	L_NC
que ni hecho de encargo	L_RG
que ni pintado	L_RG
que pela	L_RG
que si tal que si cual	L_RG
queso fresco	L_NC
quiera que no	L_RG
quieras que no	L_RG
química ambiental	L_NCFS000
química general	L_NCMS000
química industrial	L_NCMS000
rad Fh s	L_NCFS000
radiación solar	L_NC
radiación ultravioleta	L_NC
radián Fh segundo	L_NC
radián por segundo	L_NC
ramo de flores	L_NC
rara vez	L_RG
rayos x	L_NCMP000
reacción química	L_NC
real decreto ley	L_NCMS000
recaudación de impuestos	L_NCMS000
reconocimiento de voz	L_NCMS000
recurso administrativo	L_NC
recursos hídricos	L_NCMP000
recursos públicos	L_NCMP000
red de datos	L_NCFS000
red de relaciones	L_NCFS000
red ethernet	L_NCFS000
red informática	L_NCFS000
red privada	L_NCFS000
red pública	L_NCFS000
red telefónica	L_NCFS000
reducción de jornada	L_NCFS000
reducción de la jornada	L_NCFS000
reforma constitucional	L_NC
reforma tributaria	L_NC
registro de datos	L_NC
regla de oro	L_NC
regresión lineal	L_NCFS000
reino animal	L_NCMS000
reinserción social	L_NCMS000
relaciones de producción	L_NCFP000
relaciones diplomáticas	L_NCFP000
relaciones humanas	L_NCFP000
relación bilateral	L_NCFS000
relación de dependencia	L_NCFS000
relación jurídica	L_NCFS000
relación personal	L_NC
relata réfero	L_RG
rendimiento escolar	L_NCMS000
renta variable	L_NC
rentabilidad económica	L_NC
representación diplomática	L_NC
representación gráfica	L_NC
representación legal	L_NC
representación proporcional	L_NCFS000
representante del gobierno	L_NC
reproducción asistida	L_NCFS000
reproductor de dvd	L_NC
república federal	L_NCFS000
reserva de la biosfera	L_NC
reserva legal	L_NCFS000
residencia habitual	L_NCFS000
residencia oficial	L_NC
resistencia de materiales	L_NCFS000
resolución administrativa	L_NC
resolución impugnada	L_NC
respecto a	L_SPS00
respecto a que	L_CS
respecto de	L_SPS00
responsabilidad administrativa	L_NC
responsabilidad civil	L_NC
resultado oficial	L_NC
retraso mental	L_NCMS000
revolución cultural	L_NCFS000
revolución francesa	L_NCFS000
revolución socialista	L_NCFS000
riesgo social	L_NC
rigor científico	L_NCMS000
ritmo cardiaco	L_NCMS000
ritmo de trabajo	L_NCMS000
rock and roll	L_NCMS000
role playing	L_NCMS000
roll on	L_AQ0CN0
régimen capitalista	L_NCMS000
régimen democrático	L_NCMS000
régimen disciplinario	L_NCMS000
régimen económico	L_NCMS000
régimen general de la seguridad social	L_NCMS000
régimen jurídico	L_NCMS000
régimen político	L_NCMS000
régimen tributario	L_NCMS000
río abajo	L_RG
río arriba	L_RG
sagrada familia	L_NCMS000
sala de prensa	L_NC
salario base	L_NC
salario mínimo	L_NC
salga lo que salga	L_RG
salsa de tomate	L_NC
salud ambiental	L_NCFS000
salud bucodental	L_NCFS000
salón de plenos	L_NC
santa misa	L_NCFS000
santo oficio	L_NCMS000
santo sepulcro	L_NCMS000
santísima trinidad	L_NCMS000
santísimo sacramento	L_NCMS000
sea cual fuere	L_RG
sea lo que fuere	L_RG
secretaría de estado	L_NCFS000
secretaría de gobierno	L_NCFS000
secretaría general	L_NCFS000
sector agrario	L_NCMS000
sector agrícola	L_NCMS000
sector económico	L_NCMS000
sector turístico	L_NCMS000
segunda guerra mundial	L_NCFS000
segunda lengua	L_NC
seguridad del estado	L_NCFS000
seguridad e higiene	L_NCFS000
seguridad internacional	L_NCFS000
seguridad jurídica	L_NCFS000
seguridad personal	L_NCFS000
seguro de accidentes	L_NC
seguro de vida	L_NC
seguro obligatorio	L_NC
seguro social	L_NC
según como	L_RG
según el decir de	L_SPS00
según que	L_CS
selección nacional	L_NC
selección natural	L_NCFS000
selva tropical	L_NC
semejante a	L_SPS00
sensu lato	L_RG
sensu stricto	L_RG
sentencia firme	L_NCFS000
sentido contrario	L_NCMS000
sentido crítico	L_NCMS000
sentido de responsabilidad	L_NCMS000
sentido del humor	L_NCMS000
sentido literal	L_NCMS000
sentimiento de culpa	L_NC
separación de poderes	L_NCFS000
servicio asistencial	L_NC
servicio de apoyo	L_NC
servicio de atención al cliente	L_NC
servicio de información	L_NC
servicio de urgencias	L_NC
servicio educativo	L_NC
servicio jurídico	L_NC
servicio meteorológico	L_NC
servicio público	L_NC
servicio turístico	L_NC
servicios funerarios	L_NCMP000
servicios sociales	L_NCMP000
servicios urbanos	L_NCMP000
servidor dns	L_NC
servidor proxy	L_NC
servidor web	L_NC
sesión continua	L_NC
sesión plenaria	L_NC
si acaso	L_RG
si bien se mira	L_RG
si no es por	L_SPS00
si no es que	L_CC
siempre y cuando	L_RG
siendo así	L_RG
silencio administrativo	L_NCMS000
similar a	L_SPS00
sin ambages	L_RG
sin chistar ni mistar	L_RG
sin comerlo ni beberlo	L_RG
sin contar con	L_SPS00
sin contar con que	L_CS
sin duda alguna	L_RG
sin ir más lejos	L_RG
sin lugar a dudas	L_RG
sin más ni más	L_RG
sin necesidad de	L_SPS00
sin ninguna duda	L_RG
sin pena ni gloria	L_RG
sin perjuicio de	L_SPS00
sin qué ni para qué	L_RG
sin ton ni son	L_RG
sin trastes	L_RG
sin venir a pelo	L_RG
sino que	L_CC
sistema abierto	L_NCMS000
sistema de clasificación	L_NC
sistema de comunicación	L_NC
sistema de correo	L_NC
sistema de defensa	L_NC
sistema de ficheros	L_NC
sistema de gestión	L_NC
sistema de gobierno	L_NC
sistema de información geográfica	L_NC
sistema de juego	L_NC
sistema de medición	L_NC
sistema de partidos	L_NC
sistema de producción	L_NC
sistema de seguridad	L_NC
sistema democrático	L_NC
sistema económico	L_NC
sistema educativo	L_NC
sistema electoral	L_NC
sistema electrónico	L_NC
sistema federal	L_NC
sistema fiscal	L_NC
sistema informático	L_NC
sistema métrico	L_NCMS000
sistema nacional de salud	L_NCMS000
sistema nervioso	L_NCMS000
sistema nervioso central	L_NCMS000
sistema social	L_NCMS000
sistema tributario	L_NCMS000
sitio web	L_NC
situación administrativa	L_NCFS000
situación de emergencia	L_NC
situación económica	L_NCFS000
situación financiera	L_NCFS000
situación jurídica	L_NCFS000
so pena de que	L_CS
so pena que	L_CS
soberanía nacional	L_NCFS000
soberanía popular	L_NCFS000
sobre manera	L_RG
sobre seguro	L_RG
sociedad capitalista	L_NC
sociedad financiera	L_NC
socio fundador	L_NC
sociología política	L_NCFS000
software educativo	L_NC
solidaridad internacional	L_NCFS000
soporte físico	L_NC
sub voce	L_RG
subsecretario de estado	L_NC
suelo no urbanizable	L_NCMS000
suelo urbanizable	L_NCMS000
suministro de energía eléctrica	L_NC
superficie plana	L_NC
superficie útil	L_NCFS000
supuesto que	L_CS
sustancia química	L_NC
sábado santo	L_NCMS000
síndrome de down	L_NCMS000
súper 8	L_NCFS000
tal cual	L_RG
tal vez	L_RG
tal y como	L_CS
taller mecánico	L_NC
tamaño de la población	L_NCMS000
tamaño natural	L_NCMS000
tan pronto como	L_CS
tan siquiera	L_RG
tanto menos que	L_CS
tanto más que	L_CS
tanto peor	L_RG
tanto por ciento	L_RG
tanto por tanto	L_RG
tarjeta de identificación	L_NC
tarjeta de red	L_NC
tarjeta de sonido	L_NC
tarjeta de vídeo	L_NC
tarjeta gráfica	L_NC
tarjeta pcmcia	L_NC
tarjeta roja	L_NC
tasa de cambio	L_NC
tasa de crecimiento	L_NC
tasa de desempleo	L_NC
tasa de inflación	L_NC
tasa de paro	L_NC
taza de café	L_NC
tecnología avanzada	L_NCFS000
tecnología educativa	L_NCFS000
tejido adiposo	L_NCMS000
tejido conectivo	L_NCMS000
telefonía ip	L_NCMS000
televisión educativa	L_NCFS000
tema de investigación	L_NC
temperatura del agua	L_NCFS000
temperatura extrema	L_NC
tensión arterial	L_NCFS000
teoría crítica	L_NCFS000
teoría de la comunicación	L_NCFS000
teoría de la relatividad	L_NCFS000
teoría económica	L_NC
teoría política	L_NC
terapia física	L_NCFS000
terapia ocupacional	L_NCFS000
tercera división	L_NCFS000
tercera edad	L_NCFS000
terreno de juego	L_NC
territorio nacional	L_NCMS000
tesis doctoral	L_NC
testigo de jehová	L_NC
texto legal	L_NC
texto original	L_NC
tiempo de exposición	L_NCMS000
tiempo de servicio	L_NCMS000
tienda especializada	L_NC
tierra adentro	L_RG
tipo de cambio	L_NC
tipo de datos	L_NC
tipo de trabajo	L_NC
tipo de vegetación	L_NC
tira cómica	L_NC
tiro libre	L_NCMS000
titulación académica	L_NC
todo lo contrario	L_I
todo lo contrario	L_RG
toma de decisiones	L_NCFS000
tonelada métrico	L_NC
tono de voz	L_NC
tono muscular	L_NCMS000
trabajo asalariado	L_NCMS000
trabajo de campo	L_NC
trabajo doméstico	L_NC
trabajo en grupo	L_NC
trabajo grupal	L_NCMS000
trabajo nocturno	L_NC
trabajos forzados	L_NCMP000
tracto gastrointestinal	L_NCMS000
traducción automática	L_NCFS000
transacción comercial	L_NC
transferencia de datos	L_NC
transferencia de información	L_NCFS000
transmisión de datos	L_NC
transporte aéreo	L_NC
transporte de viajeros	L_NCMS000
transporte público	L_NCMS000
tratado de la unión europea	L_NCMS000
tratado de paz	L_NC
tratamiento de aguas residuales	L_NCMS000
tratamiento de datos	L_NCMS000
tratamiento de imágenes	L_NCMS000
tratamiento térmico	L_NCMS000
tribunal de apelación	L_NC
tribunal superior de justicia	L_NCMS000
tráfico de drogas	L_NCMS000
tumor cerebral	L_NC
turismo activo	L_NCMS000
tutti quanti	L_RG
té verde	L_NCMS000
técnica de evaluación	L_NC
técnica mixta	L_NC
técnico auxiliar	L_NC
técnico económico	L_NC
título académico	L_NC
título de bachiller	L_NC
título de propiedad	L_NC
título oneroso	L_NCMS000
título preliminar	L_NCMS000
título profesional	L_NC
título superior	L_NCMS000
un día u otro	L_RG
un día y otro	L_RG
un poco tarde	L_RG
una vez que	L_CS
una y no más	L_RG
unidad administrativa	L_NC
unidad de control	L_NC
unidad de cuidados intensivos	L_NCFS000
unidad de gestión	L_NC
unidad de información	L_NC
unidad de masa atómica	L_NC
unidad de medida	L_NC
unidad de producción	L_NC
unidad de tiempo	L_NC
unidad didáctica	L_NC
unidad familiar	L_NCFS000
universidad del país vasco	L_NCFS000
universidad nacional de educación a distancia	L_NCFS000
unión aduanera	L_NCFS000
unión económica	L_NCFS000
unión económica y monetaria	L_NCFS000
unión europea	L_NCFS000
unión general de trabajadores	L_NCFS000
uno por uno	L_RG
urbi et orbi	L_AQ0CN0
urbi et orbi	L_RG
uso privado	L_NCMS000
uso residencial	L_NCMS000
usuario registrado	L_NC
utilidad pública	L_NCFS000
v Fh m	L_NCFS000
valor absoluto	L_NC
valor artístico	L_NCMS000
valor de mercado	L_NC
valor económico	L_NCMS000
valor estimado	L_NCMS000
valor inicial	L_NC
valor medio	L_NCMS000
valor nominal	L_NCMS000
valor numérico	L_NCMS000
valor probatorio	L_NCMS000
valor social	L_NCMS000
valores mobiliarios	L_NCMP000
vapor de agua	L_NCMS000
varita mágica	L_NC
vaso de vino	L_NC
vaya por dios	L_I
velis nolis	L_RG
velocidad de la luz	L_NCFS000
velocidad de transferencia	L_NCFS000
velocidad de transmisión	L_NCFS000
velocidad del viento	L_NCFS000
velocidad máxima	L_NCFS000
venta de acciones	L_NC
venta directa	L_NC
viabilidad económica	L_NCFS000
viaje de ida	L_NC
vicario general	L_NC
vida en sociedad	L_NCFS000
vida profesional	L_NCFS000
villa olímpica	L_NCFS000
violencia doméstica	L_NCFS000
violencia familiar	L_NCFS000
virus de la inmunodeficiencia humana	L_NCMN000
vitamina a	L_NCFS000
vitamina c	L_NCFS000
vitamina d	L_NCFS000
vitamina e	L_NCFS000
vivienda habitual	L_NCFS000
vivienda social	L_NCFS000
volt Fh metro	L_NC
volt por metro	L_NC
volumen de negocios	L_NCMS000
volumen de trabajo	L_NCMS000
voluntariado social	L_NCMS000
voto a bríos	L_RG
voto particular	L_NCMS000
vox populi	L_RG
vía férrea	L_NC
vía respiratoria	L_NC
vídeo vhs	L_NCMS000
w Fh m K	L_NCFS000
w Fh srad	L_NCFS000
watt Fh estereoradián	L_NC
watt Fh metro Fh grado kelvin	L_NC
watt Fh metro Fh kelvin	L_NC
watt Fh metro por grado kelvin	L_NC
watt Fh metro por kelvin	L_NC
watt por estereoradián	L_NC
watt por metro Fh grado kelvin	L_NC
watt por metro Fh kelvin	L_NC
watt por metro por grado kelvin	L_NC
watt por metro por kelvin	L_NC
ya es mucho decir	L_RG
ya que	L_CS
ya será menos	L_RG
yarda cuadrado	L_NC
yarda cúbico	L_NC
zona arqueológica	L_NC
zona comercial	L_NC
zona de descanso	L_NC
zona de libre comercio	L_NCFS000
zona de trabajo	L_NC
zona franca	L_NCFS000
zona horaria	L_NCFS000
zona privada	L_NC
zona residencial	L_NC
zona restringida	L_NC
zona turística	L_NC
Ácido acético	L_NCMS000
Ácido clorhídrico	L_NCMS000
Ácido fólico	L_NCMS000
Ácido láctico	L_NCMS000
Ácido sulfúrico	L_NCMS000
Ácido úrico	L_NCMS000
Ámbito de aplicación	L_NC
Ámbito territorial	L_NC
Ángela maría	L_I
Árbol frutal	L_NC
Árbol genealógico	L_NC
Ídem de ídem	L_RG
Índice de desarrollo humano	L_NCMS000
Índice de precios al consumo	L_NCMS000
Óleo sobre lienzo	L_NC
Órgano consultivo	L_NC
Órgano de gobierno	L_NC
Óxido nítrico	L_NCFS000
ácido acético	L_NCMS000
ácido clorhídrico	L_NCMS000
ácido fólico	L_NCMS000
ácido láctico	L_NCMS000
ácido sulfúrico	L_NCMS000
ácido úrico	L_NCMS000
ámbito de aplicación	L_NC
ámbito territorial	L_NC
ángela maría	L_I
árbol frutal	L_NC
árbol genealógico	L_NC
ídem de ídem	L_RG
índice de desarrollo humano	L_NCMS000
índice de precios al consumo	L_NCMS000
óleo sobre lienzo	L_NC
órgano consultivo	L_NC
órgano de gobierno	L_NC
óxido nítrico	L_NCFS000
